,region,year,"male_Employed, as % of total population","male_Students, as % of total population","female_Employed, as % of total population","female_Students, as % of total population","combined_Employed, as % of total population","combined_Students, as % of total population",male_length_education,female_length_education,combined_length_education,male_0_18,male_18_64,male_65,female_0_18,female_18_64,female_65,combined_0_18,combined_18_64,combined_65,pop_total,cost
0,Central Finland,1993,35.8,8.1,32.7,9.2,34.2,8.6,236.0,226.9,231.3,33139,82320,13731,31514,78184,23034,64653,160504,36765,258485,775.2
1,Central Finland,1994,36.9,8.5,32.8,9.6,34.8,9.1,240.0,233.0,236.4,32988,82406,14113,31524,78412,23429,64512,160818,37542,259392,743.7
2,Central Finland,1995,37.2,9.0,32.7,10.2,34.9,9.6,244.8,239.1,241.9,32715,82518,14473,31322,78565,23728,64037,161083,38201,259778,770.7
3,Central Finland,1996,37.5,8.7,33.2,9.6,35.3,9.2,249.4,245.4,247.4,32563,82863,14887,31092,78943,24042,63655,161806,38929,260835,807.7
4,Central Finland,1997,39.0,8.7,33.8,9.9,36.4,9.3,254.3,251.8,253.0,32311,83018,15197,30859,79184,24347,63170,162202,39544,261559,860.5
5,Central Finland,1998,40.4,8.2,35.4,9.0,37.9,8.6,259.2,258.5,258.8,31968,83088,15433,30668,79575,24481,62636,162663,39914,261754,883.9
6,Central Finland,1999,41.4,8.0,36.0,8.7,38.7,8.4,263.9,264.6,264.3,31739,83255,15655,30350,79757,24722,62089,163012,40377,262106,912.2
7,Central Finland,2000,42.6,8.0,36.9,8.7,39.7,8.3,268.5,271.1,269.9,31508,83663,16019,30066,80164,24896,61574,163827,40915,262710,955.8
8,Central Finland,2001,42.3,8.1,37.0,9.0,39.6,8.6,273.7,277.5,275.6,31096,84156,16252,29847,80690,25094,60943,164846,41346,263574,1023.9
9,Central Finland,2002,42.3,8.1,37.5,8.8,39.9,8.4,278.5,282.8,280.7,30706,84355,16644,29539,80892,25335,60245,165247,41979,263889,1091.4
10,Central Finland,2003,42.4,8.4,37.6,9.0,39.9,8.7,284.0,290.0,287.1,30426,84650,17098,29356,81237,25582,59782,165887,42680,264936,1181.1
11,Central Finland,2004,42.6,8.4,37.8,9.0,40.2,8.7,289.1,297.0,293.2,30283,84806,17583,29176,81450,26105,59459,166256,43688,266047,1242.8
12,Central Finland,2005,42.4,8.9,37.4,9.3,39.9,9.1,293.1,302.6,298.0,30082,84970,18014,29036,81469,26384,59118,166439,44398,266770,1287.0
13,Central Finland,2006,43.3,8.7,38.2,9.2,40.7,8.9,297.1,308.8,303.1,30104,84602,18906,29034,81294,27025,59138,165896,45931,267481,1330.1
14,Central Finland,2007,43.8,8.5,39.1,9.0,41.4,8.7,302.7,316.1,309.6,29981,84935,18991,28865,81500,27034,58846,166435,46025,267998,1400.8
15,Central Finland,2008,43.3,8.3,39.7,8.7,41.5,8.5,307.7,324.2,316.1,29865,85172,19431,28870,81861,27345,58735,167033,46776,269108,1489.4
16,Central Finland,2009,40.8,8.7,38.8,8.9,39.8,8.8,311.6,330.3,321.2,29865,85347,19848,28799,82063,27658,58664,167410,47506,270195,1544.5
17,Central Finland,2010,41.7,8.5,39.5,8.7,40.6,8.6,316.0,336.4,326.4,29789,85272,20617,28709,81888,28300,58498,167160,48917,271083,1568.6
18,Central Finland,2011,41.8,8.5,39.7,8.4,40.7,8.4,320.4,343.2,332.0,29700,84912,21496,28545,81472,29106,58245,166384,50602,271874,1655.4
19,Central Finland,2012,40.7,8.4,39.3,8.4,40.0,8.4,324.5,349.5,337.2,29577,84503,22549,28480,81052,29953,58057,165555,52502,272723,1749.0
20,Central Finland,2013,39.1,8.4,38.4,8.4,38.7,8.4,329.6,356.1,343.1,29338,83726,23715,28243,80211,30905,57581,163937,54620,272911,1829.4
21,Central Finland,2014,38.8,8.4,37.9,8.4,38.3,8.4,334.0,362.1,348.3,29211,83086,24626,28112,79498,31698,57323,162584,56324,272990,1828.7
22,Central Finland,2015,38.5,8.5,37.5,8.4,38.0,8.5,336.5,366.7,351.8,29001,82655,25516,27941,78945,32488,56942,161600,58004,273446,1842.5
23,Central Finland,2016,39.2,8.5,37.8,8.2,38.5,8.4,340.3,372.3,356.5,28865,82600,26210,27737,78471,33005,56602,161071,59215,273910,1826.7
24,Central Finland,2017,40.4,8.2,38.5,8.1,39.4,8.1,345.3,379.4,362.6,28706,81959,27026,27448,77949,33648,56154,159908,60674,273779,1871.9
25,Central Finland,2018,40.8,8.2,39.2,8.1,40.0,8.1,350.7,387.3,369.3,28443,81478,27580,27155,77342,34266,55598,158820,61846,273283,1880.0
26,Central Finland,2019,40.5,8.3,39.2,8.3,39.8,8.3,354.0,392.5,373.5,27988,81023,28296,26825,76756,34905,54813,157779,63201,272898,1903.1
27,Central Finland,2020,39.0,8.7,38.0,8.7,38.5,8.7,357.9,398.5,378.4,27732,80506,28957,26546,76246,35548,54278,156752,64505,272617,1991.5
28,Central Ostrobothnia,1993,36.8,8.9,31.5,10.5,34.1,9.7,202.0,208.2,205.2,10126,21269,3456,9762,20242,5593,19888,41511,9049,69315,677.7
29,Central Ostrobothnia,1994,37.9,9.8,32.3,10.5,35.1,10.1,206.7,214.0,210.4,10038,21368,3535,9696,20366,5725,19734,41734,9260,69627,680.9
30,Central Ostrobothnia,1995,38.3,9.6,31.7,10.6,35.0,10.1,210.4,220.3,215.4,9928,21342,3656,9622,20348,5801,19550,41690,9457,69539,714.3
31,Central Ostrobothnia,1996,38.6,9.6,32.2,10.5,35.4,10.0,214.3,225.3,219.9,9752,21279,3755,9426,20229,5867,19178,41508,9622,69213,749.1
32,Central Ostrobothnia,1997,40.2,9.6,32.9,10.6,36.5,10.1,218.8,230.8,225.0,9578,21249,3857,9337,20152,5912,18915,41401,9769,69021,813.8
33,Central Ostrobothnia,1998,41.9,9.0,34.7,9.7,38.3,9.3,223.2,235.5,229.5,9444,21229,3924,9236,20068,5962,18680,41297,9886,68773,827.9
34,Central Ostrobothnia,1999,42.5,9.0,35.3,9.2,38.8,9.1,226.4,240.7,233.7,9248,21109,4024,9084,19959,6021,18332,41068,10045,68345,849.1
35,Central Ostrobothnia,2000,43.3,8.4,35.9,9.0,39.6,8.7,229.3,245.8,237.7,9101,21019,4117,8946,19913,6098,18047,40932,10215,68052,899.2
36,Central Ostrobothnia,2001,43.7,8.4,36.3,9.0,40.0,8.7,233.1,251.3,242.4,8910,20948,4172,8751,19809,6177,17661,40757,10349,67671,988.7
37,Central Ostrobothnia,2002,43.9,8.6,37.7,8.7,40.7,8.6,239.0,256.1,247.7,8759,20913,4266,8626,19842,6196,17385,40755,10462,67497,1048.4
38,Central Ostrobothnia,2003,43.8,8.3,37.6,8.7,40.6,8.5,243.9,262.3,253.3,8642,20855,4384,8522,19858,6237,17164,40713,10621,67441,1128.3
39,Central Ostrobothnia,2004,43.8,8.4,38.2,8.6,41.0,8.5,248.4,269.0,258.9,8569,20810,4508,8334,19829,6336,16903,40639,10844,67369,1218.0
40,Central Ostrobothnia,2005,43.7,8.8,37.9,8.8,40.7,8.8,252.5,275.7,264.3,8536,20880,4592,8316,19856,6409,16852,40736,11001,67612,1276.6
41,Central Ostrobothnia,2006,44.9,8.4,38.8,8.8,41.8,8.6,256.9,281.9,269.6,8407,20747,4791,8301,19744,6605,16708,40491,11396,67632,1345.0
42,Central Ostrobothnia,2007,45.6,8.0,39.8,8.3,42.7,8.2,261.5,287.8,274.9,8398,20833,4815,8305,19872,6651,16703,40705,11466,67898,1442.6
43,Central Ostrobothnia,2008,44.5,7.9,39.9,7.9,42.2,7.9,265.2,294.8,280.2,8378,20878,4909,8223,19902,6709,16601,40780,11618,67991,1571.1
44,Central Ostrobothnia,2009,42.6,7.8,39.3,8.1,40.9,7.9,269.6,301.0,285.6,8361,20756,5001,8210,19891,6837,16571,40647,11838,68131,1620.6
45,Central Ostrobothnia,2010,43.6,7.7,39.8,8.2,41.7,8.0,274.6,307.1,291.2,8399,20638,5213,8177,19856,6988,16576,40494,12201,68321,1782.6
46,Central Ostrobothnia,2011,43.5,7.5,40.1,8.1,41.8,7.8,278.3,313.4,296.2,8394,20514,5489,8175,19710,7174,16569,40224,12663,68484,1907.2
47,Central Ostrobothnia,2012,43.1,7.5,40.2,8.0,41.6,7.7,282.4,319.4,301.2,8356,20339,5747,8151,19506,7446,16507,39845,13193,68610,1956.8
48,Central Ostrobothnia,2013,42.4,7.5,39.8,7.8,41.1,7.7,287.7,325.6,306.9,8361,20109,6025,8150,19368,7648,16511,39477,13673,68677,1984.0
49,Central Ostrobothnia,2014,41.5,7.2,39.3,7.3,40.4,7.3,291.7,332.5,312.4,8367,19952,6278,8116,19156,7868,16483,39108,14146,68830,1945.2
50,Central Ostrobothnia,2015,41.1,7.3,38.9,7.2,40.0,7.2,293.9,338.3,316.4,8375,19839,6503,8135,19018,8037,16510,38857,14540,69032,1971.8
51,Central Ostrobothnia,2016,40.9,7.1,38.5,7.3,39.7,7.2,296.8,343.2,320.3,8391,19660,6719,8105,18805,8208,16496,38465,14927,69027,2018.3
52,Central Ostrobothnia,2017,41.7,6.9,39.6,7.1,40.6,7.0,301.5,349.3,325.7,8344,19372,6910,8049,18555,8378,16393,37927,15288,68780,1986.3
53,Central Ostrobothnia,2018,42.3,6.6,40.3,6.9,41.3,6.7,306.4,356.6,331.8,8304,19110,7081,8002,18248,8535,16306,37358,15616,68437,2047.0
54,Central Ostrobothnia,2019,41.9,6.8,39.9,6.7,40.9,6.8,310.4,362.1,336.6,8204,18853,7258,7981,18049,8658,16185,36902,15916,68158,2044.2
55,Central Ostrobothnia,2020,40.8,7.0,39.6,6.9,40.2,6.9,314.6,367.9,341.5,8164,18781,7391,7883,17840,8803,16047,36621,16194,67988,2202.7
56,Kainuu,1993,32.8,8.7,31.0,10.0,31.9,9.3,214.5,214.2,214.3,12004,29832,4817,11763,27269,7369,23767,57101,12186,91794,805.8
57,Kainuu,1994,34.0,9.1,31.3,10.2,32.6,9.6,218.0,219.2,218.6,11869,29517,5040,11665,27063,7571,23534,56580,12611,91350,804.5
58,Kainuu,1995,32.7,9.3,31.2,10.5,32.0,9.9,221.2,224.4,222.8,11707,29166,5280,11420,26801,7752,23127,55967,13032,90781,827.6
59,Kainuu,1996,31.5,9.0,31.0,10.0,31.3,9.5,225.2,229.3,227.2,11490,28837,5435,11197,26430,7935,22687,55267,13370,90035,881.3
60,Kainuu,1997,33.9,9.4,31.7,10.5,32.8,9.9,227.8,233.1,230.5,11111,28480,5526,10988,26046,8104,22099,54526,13630,88896,916.4
61,Kainuu,1998,35.7,8.6,32.9,9.3,34.3,8.9,230.9,237.8,234.4,10817,28157,5607,10636,25748,8216,21453,53905,13823,87843,941.4
62,Kainuu,1999,36.3,8.4,33.0,9.2,34.7,8.8,234.3,242.1,238.2,10517,27840,5745,10348,25459,8277,20865,53299,14022,86943,939.3
63,Kainuu,2000,37.0,8.2,33.5,8.7,35.3,8.5,236.7,245.9,241.3,10208,27427,5868,10087,25032,8447,20295,52459,14315,85736,970.1
64,Kainuu,2001,35.6,8.2,33.4,8.5,34.5,8.3,239.5,250.5,245.0,9795,27106,5994,9708,24702,8570,19503,51808,14564,84497,1050.0
65,Kainuu,2002,35.5,8.4,33.7,8.8,34.6,8.6,242.8,254.0,248.4,9472,26818,6068,9318,24390,8661,18790,51208,14729,83477,1128.0
66,Kainuu,2003,36.4,8.3,34.3,8.8,35.3,8.6,246.8,258.9,252.9,9234,26506,6222,9072,24190,8741,18306,50696,14963,82744,1222.8
67,Kainuu,2004,37.0,8.0,34.5,8.3,35.7,8.2,250.8,264.6,257.7,9014,26293,6382,8825,23930,8924,17839,50223,15306,82214,1296.2
68,Kainuu,2005,36.5,8.7,34.5,8.5,35.5,8.6,255.0,269.4,262.2,8831,26058,6451,8582,23749,9022,17413,49807,15473,81585,1261.7
69,Kainuu,2006,37.6,8.3,35.3,8.3,36.5,8.3,260.3,276.2,268.3,8651,25617,6674,8318,23358,9220,16969,48975,15894,80738,1406.3
70,Kainuu,2007,39.2,8.3,36.0,8.3,37.6,8.3,264.1,282.0,273.1,8453,25473,6705,8133,23228,9239,16586,48701,15944,80218,1456.2
71,Kainuu,2008,37.9,8.0,36.9,8.0,37.4,8.0,269.0,289.2,279.2,8296,25297,6814,8025,23102,9251,16321,48399,16065,79690,1509.5
72,Kainuu,2009,36.5,8.2,37.0,8.0,36.8,8.1,273.5,295.2,284.4,8119,25071,6881,7899,22955,9315,16018,48026,16196,79234,1616.4
73,Kainuu,2010,37.8,8.0,37.3,7.9,37.6,7.9,277.4,300.5,289.0,7995,24797,7072,7758,22666,9473,15753,47463,16545,78703,1705.3
74,Kainuu,2011,38.5,7.7,37.8,7.6,38.1,7.7,281.5,305.9,293.7,7812,24456,7293,7546,22281,9611,15358,46737,16904,77984,1916.1
75,Kainuu,2012,37.7,7.5,37.8,7.3,37.7,7.4,285.4,310.7,298.1,7633,24103,7517,7410,21902,9857,15043,46005,17374,77435,2029.9
76,Kainuu,2013,35.8,7.0,36.9,6.9,36.4,7.0,290.3,316.0,303.2,7460,23662,7816,7251,21440,10113,14711,45102,17929,76782,2280.9
77,Kainuu,2014,35.0,6.9,36.7,6.7,35.9,6.8,293.9,322.0,308.0,7299,23190,8093,7115,21061,10288,14414,44251,18381,76119,2291.2
78,Kainuu,2015,35.5,6.8,36.5,6.6,36.0,6.7,295.5,327.2,311.4,7131,22673,8353,6845,20677,10438,13976,43350,18791,75324,2331.9
79,Kainuu,2016,36.7,6.7,36.9,6.5,36.8,6.6,299.2,332.9,316.1,7123,22265,8602,6739,20283,10593,13862,42548,19195,74803,2349.2
80,Kainuu,2017,36.8,6.8,37.1,6.3,37.0,6.5,304.1,339.5,321.8,6954,21749,8874,6648,19727,10784,13602,41476,19658,73959,2380.7
81,Kainuu,2018,38.1,6.5,38.1,6.0,38.1,6.2,309.0,347.2,328.1,6811,21231,9128,6471,19239,10950,13282,40470,20078,73061,2687.9
82,Kainuu,2019,37.6,6.6,38.1,5.9,37.8,6.2,311.9,351.5,331.6,6688,20708,9459,6329,18727,11142,13017,39435,20601,72306,2708.6
83,Kainuu,2020,37.7,6.8,37.9,6.1,37.8,6.4,314.8,357.6,336.1,6558,20416,9684,6177,18296,11260,12735,38712,20944,71664,3024.0
84,Kanta-Häme,1993,38.6,7.3,34.9,8.0,36.7,7.7,235.2,213.8,224.0,19652,51740,9513,18820,50149,16898,38472,101889,26411,164767,781.0
85,Kanta-Häme,1994,39.8,7.4,35.3,7.9,37.5,7.7,239.5,219.4,229.0,19642,51635,9744,18913,49993,17117,38555,101628,26861,164957,764.9
86,Kanta-Häme,1995,40.1,7.4,34.9,8.2,37.4,7.8,243.7,224.8,233.8,19554,51434,9940,18898,49770,17372,38452,101204,27312,164937,810.4
87,Kanta-Häme,1996,40.1,7.2,35.6,7.7,37.8,7.5,247.2,230.3,238.4,19501,51288,10177,18793,49691,17462,38294,100979,27639,164892,858.5
88,Kanta-Häme,1997,42.2,7.3,36.5,7.8,39.3,7.5,250.9,235.7,243.0,19460,51271,10316,18743,49666,17547,38203,100937,27863,165026,909.7
89,Kanta-Häme,1998,44.0,6.7,38.0,7.1,40.9,6.9,254.6,241.4,247.7,19371,51235,10407,18599,49718,17496,37970,100953,27903,164914,932.9
90,Kanta-Häme,1999,44.5,6.6,38.6,7.0,41.5,6.8,258.3,246.7,252.2,19412,51243,10619,18528,49878,17487,37940,101121,28106,165190,931.6
91,Kanta-Häme,2000,45.4,6.4,39.2,6.8,42.2,6.6,261.7,252.4,256.8,19351,51204,10831,18505,49913,17540,37856,101117,28371,165307,936.3
92,Kanta-Häme,2001,45.4,6.4,39.9,6.8,42.6,6.6,265.2,257.7,261.3,19265,51344,11039,18443,50037,17559,37708,101381,28598,165509,964.8
93,Kanta-Häme,2002,45.4,6.5,40.3,6.9,42.8,6.7,268.8,262.8,265.7,18996,51491,11309,18290,50209,17664,37286,101700,28973,165886,1020.0
94,Kanta-Häme,2003,45.4,6.5,40.5,6.8,42.9,6.7,273.7,269.4,271.5,18963,51602,11600,18279,50403,17796,37242,102005,29396,166648,1084.1
95,Kanta-Häme,2004,45.6,6.4,40.6,6.7,43.0,6.6,278.0,275.8,276.8,18981,51727,11875,18411,50584,18047,37392,102311,29922,167630,1165.5
96,Kanta-Häme,2005,45.5,7.0,40.8,7.1,43.1,7.0,282.1,282.6,282.4,19008,52004,11983,18387,50894,18068,37395,102898,30051,168381,1242.6
97,Kanta-Häme,2006,46.4,7.0,41.6,6.9,44.0,7.0,286.1,289.2,287.7,19189,52340,12450,18445,51046,18533,37634,103386,30983,169952,1294.4
98,Kanta-Häme,2007,47.1,6.8,42.7,6.8,44.8,6.8,289.8,296.5,293.2,19277,52868,12561,18563,51738,18466,37840,104606,31027,171449,1341.9
99,Kanta-Häme,2008,45.9,6.8,42.9,6.6,44.4,6.7,293.4,303.3,298.5,19392,53328,12877,18711,52135,18749,38103,105463,31626,173041,1485.0
100,Kanta-Häme,2009,43.4,7.0,42.1,6.9,42.8,6.9,297.6,309.7,303.9,19384,53439,13202,18635,52450,18937,38019,105889,32139,173828,1536.6
101,Kanta-Häme,2010,44.1,6.9,42.1,7.0,43.0,7.0,301.0,315.4,308.5,19281,53480,13762,18501,52411,19349,37782,105891,33111,174555,1562.7
102,Kanta-Häme,2011,44.5,6.8,42.3,6.7,43.4,6.8,304.4,320.4,312.7,19148,53128,14518,18418,52067,20057,37566,105195,34575,175230,1620.9
103,Kanta-Häme,2012,44.0,6.8,42.0,6.6,43.0,6.7,306.9,326.0,316.8,19101,52760,15242,18281,51597,20666,37382,104357,35908,175472,1671.6
104,Kanta-Häme,2013,42.9,6.8,41.2,6.7,42.0,6.8,310.8,332.5,322.0,18979,52370,15869,18106,51106,21226,37085,103476,37095,175481,1739.2
105,Kanta-Häme,2014,42.1,6.9,40.8,6.6,41.4,6.7,313.7,337.3,325.8,18829,51976,16500,17883,50458,21800,36712,102434,38300,175349,1784.1
106,Kanta-Häme,2015,41.4,6.8,40.0,6.7,40.7,6.8,315.5,340.6,328.4,18555,51463,17050,17622,49791,22319,36177,101254,39369,174710,1818.1
107,Kanta-Häme,2016,41.6,6.6,39.9,6.5,40.7,6.5,318.2,345.3,332.1,18282,50836,17530,17293,48975,22803,35575,99811,40333,173781,1850.1
108,Kanta-Häme,2017,42.1,6.7,40.4,6.4,41.2,6.6,321.3,351.3,336.7,18043,50189,18102,16991,48194,23208,35034,98383,41310,172720,1924.6
109,Kanta-Häme,2018,42.8,6.4,40.9,6.2,41.8,6.3,325.5,358.3,342.3,17693,49431,18589,16595,47339,23649,34288,96770,42238,171364,1945.2
110,Kanta-Häme,2019,42.3,6.5,41.0,6.4,41.6,6.4,328.9,363.5,346.6,17351,49012,19061,16339,46877,24132,33690,95889,43193,170925,1999.6
111,Kanta-Häme,2020,41.0,6.7,40.2,6.7,40.6,6.7,332.0,368.2,350.5,17179,48706,19472,16012,46514,24592,33191,95220,44064,170577,2077.3
112,Kymenlaakso,1993,39.1,7.6,33.5,8.2,36.2,7.9,237.4,209.9,223.2,21234,60327,10635,20312,57059,18866,41546,117386,29501,186054,707.9
113,Kymenlaakso,1994,40.4,7.6,33.6,8.2,36.9,7.9,241.1,215.0,227.6,21084,59965,10970,20184,56706,19043,41268,116671,30013,185462,697.5
114,Kymenlaakso,1995,40.9,7.5,33.4,8.5,37.1,8.0,244.6,220.2,232.0,20782,59522,11251,19952,56223,19223,40734,115745,30474,184595,738.0
115,Kymenlaakso,1996,40.6,7.2,34.1,8.0,37.2,7.6,248.2,225.4,236.4,20584,59000,11498,19751,55846,19372,40335,114846,30870,183819,780.3
116,Kymenlaakso,1997,41.9,7.4,34.7,7.8,38.2,7.6,251.2,230.4,240.4,20305,58591,11718,19605,55488,19503,39910,114079,31221,182942,848.9
117,Kymenlaakso,1998,43.0,7.0,35.6,7.3,39.2,7.2,254.8,234.8,244.5,20071,58333,11833,19431,55221,19536,39502,113554,31369,182215,842.7
118,Kymenlaakso,1999,43.0,6.9,36.3,7.0,39.6,7.0,257.2,239.2,247.9,19836,57846,12072,19175,54838,19530,39011,112684,31602,181122,891.0
119,Kymenlaakso,2000,43.7,6.8,36.8,6.9,40.2,6.8,260.1,244.2,251.9,19592,57420,12246,18918,54488,19559,38510,111908,31805,179940,914.9
120,Kymenlaakso,2001,43.8,6.8,37.1,6.8,40.4,6.8,262.7,248.8,255.5,19377,57186,12492,18661,54276,19602,38038,111462,32094,179292,998.9
121,Kymenlaakso,2002,43.6,6.9,37.5,6.8,40.5,6.8,266.0,253.3,259.5,19069,57101,12679,18386,54024,19664,37455,111125,32343,178735,1058.6
122,Kymenlaakso,2003,43.6,6.7,37.9,6.8,40.7,6.8,269.3,258.7,263.9,18832,56969,12998,18130,53806,19784,36962,110775,32782,178341,1160.4
123,Kymenlaakso,2004,43.8,6.6,38.0,6.6,40.9,6.6,272.2,264.3,268.2,18629,56697,13369,17906,53535,20049,36535,110232,33418,178205,1253.6
124,Kymenlaakso,2005,43.6,7.0,37.6,7.1,40.5,7.1,275.3,270.0,272.6,18501,56481,13557,17823,53419,20175,36324,109900,33732,177931,1325.0
125,Kymenlaakso,2006,43.7,7.0,38.3,7.0,41.0,7.0,278.8,275.7,277.2,18200,55770,14043,17610,52828,20634,35810,108598,34677,176995,1378.7
126,Kymenlaakso,2007,44.2,6.9,39.0,7.0,41.5,7.0,281.3,281.4,281.4,18048,55601,14070,17379,52656,20669,35427,108257,34739,176356,1396.6
127,Kymenlaakso,2008,43.1,6.7,39.2,6.7,41.1,6.7,283.6,287.1,285.4,17790,55238,14423,17143,52373,20836,34933,107611,35259,175661,1553.4
128,Kymenlaakso,2009,39.8,7.1,38.4,6.8,39.1,7.0,287.3,292.6,290.1,17611,55014,14742,16922,52117,21103,34533,107131,35845,175403,1569.9
129,Kymenlaakso,2010,40.6,6.9,38.5,6.6,39.5,6.8,289.7,297.2,293.5,17469,54521,15404,16825,51644,21640,34294,106165,37044,175377,1600.1
130,Kymenlaakso,2011,40.2,6.9,38.6,6.5,39.4,6.7,291.9,301.8,297.0,17194,53894,16088,16608,50989,22203,33802,104883,38291,174827,1695.1
131,Kymenlaakso,2012,39.1,6.8,38.7,6.2,38.9,6.5,294.0,306.5,300.4,17026,53228,16771,16433,50282,22864,33459,103510,39635,174466,1814.9
132,Kymenlaakso,2013,38.2,6.4,37.9,6.1,38.0,6.2,297.4,312.6,305.2,16722,52522,17419,16180,49588,23518,32902,102110,40937,173864,1846.2
133,Kymenlaakso,2014,37.5,6.7,37.1,6.3,37.3,6.5,300.3,317.3,309.0,16418,51600,18140,15900,48819,24006,32318,100419,42146,172907,1920.8
134,Kymenlaakso,2015,36.7,6.8,36.2,6.3,36.4,6.6,300.8,320.7,311.0,16136,50788,18723,15581,47970,24445,31717,98758,43168,171778,1916.4
135,Kymenlaakso,2016,37.1,6.7,36.0,6.2,36.6,6.4,303.6,324.6,314.3,15874,50160,19103,15357,47277,24869,31231,97437,43972,170770,1966.2
136,Kymenlaakso,2017,38.3,6.5,36.7,6.0,37.5,6.3,306.8,330.3,318.8,15464,49125,19573,14914,46145,25304,30378,95270,44877,168691,1985.8
137,Kymenlaakso,2018,39.2,6.3,37.8,5.7,38.5,6.0,312.3,338.8,325.8,15053,48255,19965,14450,45113,25530,29503,93368,45495,166623,2125.0
138,Kymenlaakso,2019,39.0,6.3,37.6,5.9,38.3,6.1,315.1,343.9,329.8,14618,47330,20201,14107,44137,25815,28725,91467,46016,164456,2214.6
139,Kymenlaakso,2020,37.7,6.5,37.1,6.0,37.4,6.2,317.5,348.8,333.5,14218,46572,20594,13715,43343,26022,27933,89915,46616,162812,2291.7
140,Lapland,1993,33.8,8.6,32.1,9.9,32.9,9.2,223.7,228.2,226.0,27317,66278,9860,26534,61164,14606,53851,127442,24466,202895,839.8
141,Lapland,1994,34.1,9.3,32.0,10.2,33.1,9.7,227.4,233.5,230.5,27091,65842,10239,26287,60723,15032,53378,126565,25271,202325,824.9
142,Lapland,1995,33.7,9.6,31.7,10.3,32.7,9.9,231.0,239.0,235.0,26622,65441,10594,25834,60378,15386,52456,125819,25980,201411,861.2
143,Lapland,1996,33.5,9.5,32.3,10.1,32.9,9.8,234.3,244.1,239.2,26304,65143,10901,25449,59901,15761,51753,125044,26662,200579,884.4
144,Lapland,1997,35.0,9.6,33.0,10.3,34.0,10.0,237.3,248.3,242.8,25817,64615,11153,24925,59415,15973,50742,124030,27126,199051,908.6
145,Lapland,1998,36.2,9.1,33.9,9.6,35.0,9.4,240.1,252.7,246.4,25110,63736,11369,24269,58774,16160,49379,122510,27529,196647,936.0
146,Lapland,1999,36.7,9.1,34.7,9.4,35.7,9.2,243.1,257.1,250.1,24535,62939,11621,23700,57904,16461,48235,120843,28082,194352,933.5
147,Lapland,2000,37.3,9.1,35.2,9.6,36.3,9.3,245.7,261.2,253.5,23915,61975,11994,22946,57159,16728,46861,119134,28722,191768,1007.3
148,Lapland,2001,37.2,8.8,35.6,8.9,36.4,8.9,248.9,265.1,257.0,23150,61264,12284,22170,56193,17045,45320,117457,29329,189288,1075.6
149,Lapland,2002,37.8,8.9,36.4,9.3,37.1,9.1,252.4,269.9,261.2,22411,60640,12683,21632,55877,17393,44043,116517,30076,187778,1149.6
150,Lapland,2003,38.2,8.9,36.6,9.4,37.4,9.1,256.4,275.1,265.8,21793,60357,13089,21048,55594,17736,42841,115951,30825,186917,1230.2
151,Lapland,2004,38.4,8.8,36.6,9.4,37.5,9.1,260.4,281.2,270.8,21333,60089,13503,20625,55362,18105,41958,115451,31608,186443,1311.1
152,Lapland,2005,38.4,9.2,36.3,9.9,37.4,9.5,264.2,286.8,275.5,20940,59841,13743,20208,55270,18273,41148,115111,32016,185800,1392.7
153,Lapland,2006,39.5,9.1,37.0,9.8,38.3,9.4,267.9,292.8,280.3,20583,59141,14245,19857,54778,18834,40440,113919,33079,184935,1464.1
154,Lapland,2007,40.5,8.9,38.0,9.6,39.3,9.3,271.1,298.5,284.9,20296,59019,14351,19508,54907,18889,39804,113926,33240,184390,1544.4
155,Lapland,2008,39.7,8.7,38.7,9.3,39.2,9.0,274.8,305.3,290.1,19994,58840,14680,19165,54865,19028,39159,113705,33708,183963,1654.6
156,Lapland,2009,37.9,8.7,38.1,9.3,38.0,9.0,279.1,310.7,295.0,19681,58883,14856,18818,54852,19207,38499,113735,34063,183748,1707.7
157,Lapland,2010,39.0,8.6,38.6,9.1,38.8,8.8,283.0,316.1,299.6,19406,58740,15197,18486,54698,19477,37892,113438,34674,183488,1765.9
158,Lapland,2011,39.3,8.4,38.8,8.7,39.0,8.6,286.8,322.4,304.6,19118,58196,15845,18296,54136,20127,37414,112332,35972,183330,1873.5
159,Lapland,2012,38.4,8.2,39.2,8.4,38.8,8.3,290.5,328.4,309.5,18900,57510,16536,18025,53591,20654,36925,111101,37190,182844,2032.3
160,Lapland,2013,37.3,7.8,38.7,8.0,38.0,7.9,295.1,335.3,315.3,18673,56702,17258,17834,52944,21232,36507,109646,38490,182514,2142.8
161,Lapland,2014,37.1,7.7,38.6,7.9,37.9,7.8,299.3,341.6,320.5,18485,55772,18025,17611,52207,21760,36096,107979,39785,181746,2253.9
162,Lapland,2015,37.0,7.5,38.5,7.6,37.7,7.5,301.8,346.3,324.1,18179,54817,18747,17366,51532,22215,35545,106349,40962,180858,2262.9
163,Lapland,2016,37.8,7.3,38.8,7.5,38.3,7.4,305.3,352.0,328.7,18071,54027,19266,17115,51074,22625,35186,105101,41891,180207,2267.6
164,Lapland,2017,38.8,6.9,39.7,7.2,39.3,7.1,311.1,360.4,335.9,17814,53040,19882,16910,50458,23035,34724,103498,42917,179223,2293.3
165,Lapland,2018,39.7,6.6,40.5,6.8,40.1,6.7,316.7,368.4,342.7,17554,52250,20491,16756,49943,23465,34310,102193,43956,178522,2444.6
166,Lapland,2019,40.2,6.4,40.9,6.8,40.5,6.6,320.0,374.2,347.3,17271,51419,20913,16427,49003,23955,33698,100422,44868,177161,2523.0
167,Lapland,2020,38.2,6.5,39.2,7.1,38.7,6.8,323.2,380.4,351.9,17063,50879,21443,16256,48326,24466,33319,99205,45909,176665,2550.7
168,North Karelia,1993,34.2,8.1,31.8,9.3,33.0,8.7,215.5,212.4,213.9,23122,58570,10313,22020,54285,17389,45142,112855,27702,183293,825.4
169,North Karelia,1994,34.5,8.6,31.5,9.4,33.0,9.0,220.0,218.5,219.2,22912,58360,10591,21882,53980,17657,44794,112340,28248,183038,811.4
170,North Karelia,1995,34.2,8.9,31.2,9.8,32.6,9.3,224.1,224.0,224.0,22757,57992,10853,21653,53525,17953,44410,111517,28806,182336,838.2
171,North Karelia,1996,33.7,8.7,31.1,9.3,32.4,9.0,227.8,229.4,228.6,22439,57504,11043,21294,53176,18044,43733,110680,29087,181160,865.9
172,North Karelia,1997,35.1,9.0,31.7,9.4,33.4,9.2,231.4,234.8,233.1,22175,57012,11230,21013,52678,18157,43188,109690,29387,179977,902.1
173,North Karelia,1998,36.4,8.6,32.7,8.9,34.5,8.7,234.8,239.8,237.4,21831,56593,11365,20625,52343,18101,42456,108936,29466,178441,909.9
174,North Karelia,1999,37.1,8.5,33.6,8.9,35.4,8.7,238.9,245.7,242.3,21374,56225,11557,20297,51963,18180,41671,108188,29737,177238,938.3
175,North Karelia,2000,37.9,8.5,34.4,9.0,36.1,8.8,242.5,250.6,246.6,20960,56072,11763,19927,51681,18230,40887,107753,29993,176187,984.2
176,North Karelia,2001,37.5,8.6,34.4,8.8,35.9,8.7,246.6,257.0,251.9,20496,55969,11983,19541,51489,18401,40037,107458,30384,175322,1028.6
177,North Karelia,2002,37.9,8.8,34.8,9.0,36.4,8.9,250.1,262.4,256.3,20039,55709,12176,19062,51279,18387,39101,106988,30563,174236,1114.0
178,North Karelia,2003,38.2,8.7,35.0,9.1,36.6,8.9,255.2,268.4,261.9,19626,55396,12476,18615,51256,18523,38241,106652,30999,173580,1226.9
179,North Karelia,2004,38.8,8.7,35.3,9.2,37.0,8.9,259.9,274.2,267.1,19194,55177,12813,18287,51159,18691,37481,106336,31504,173018,1285.8
180,North Karelia,2005,39.3,8.9,35.2,9.6,37.2,9.3,264.8,280.6,272.8,18812,55254,12896,17957,51146,18752,36769,106400,31648,172629,1376.1
181,North Karelia,2006,39.8,9.1,35.8,9.7,37.8,9.4,269.1,287.2,278.3,18455,54740,13358,17664,50702,19104,36119,105442,32462,171758,1451.1
182,North Karelia,2007,40.0,8.8,36.6,9.1,38.3,9.0,273.2,293.5,283.5,18157,54641,13385,17319,50617,19069,35476,105258,32454,170896,1548.4
183,North Karelia,2008,39.1,8.6,37.3,8.9,38.2,8.7,278.6,301.2,290.0,17782,54374,13662,16994,50392,19222,34776,104766,32884,170194,1667.3
184,North Karelia,2009,37.3,9.0,36.8,9.2,37.1,9.1,282.6,306.5,294.7,17455,54338,13922,16712,50267,19452,34167,104605,33374,169937,1722.9
185,North Karelia,2010,38.7,9.0,37.3,9.2,38.0,9.1,287.0,313.0,300.2,17156,53959,14494,16470,50123,19827,33626,104082,34321,169778,1734.6
186,North Karelia,2011,38.7,8.5,37.5,8.7,38.1,8.6,290.8,319.4,305.3,16901,53423,15142,16325,49765,20226,33226,103188,35368,169733,1805.5
187,North Karelia,2012,37.8,8.5,37.5,8.5,37.7,8.5,295.1,325.3,310.4,16697,52813,15830,16172,49314,20689,32869,102127,36519,169496,1784.5
188,North Karelia,2013,37.3,8.4,37.0,8.3,37.1,8.3,300.1,332.0,316.2,16484,52219,16454,15997,48734,21220,32481,100953,37674,169112,1993.1
189,North Karelia,2014,36.5,8.4,37.0,8.4,36.7,8.4,304.6,337.8,321.3,16251,51551,17222,15836,48269,21625,32087,99820,38847,168896,2044.3
190,North Karelia,2015,35.7,8.2,36.4,8.3,36.0,8.3,307.9,343.1,325.6,16003,50842,17880,15662,47779,22065,31665,98621,39945,168329,2066.0
191,North Karelia,2016,36.0,8.2,36.3,8.1,36.1,8.2,311.7,348.6,330.3,15779,50209,18422,15416,47196,22371,31195,97405,40793,167599,2090.2
192,North Karelia,2017,37.1,7.9,36.8,7.9,37.0,7.9,315.7,354.8,335.4,15455,49291,19095,15123,46563,22747,30578,95854,41842,166441,2024.9
193,North Karelia,2018,37.8,7.8,37.3,8.2,37.5,8.0,321.9,363.0,342.6,15181,48527,19621,14721,46110,23115,29902,94637,42736,165569,2026.5
194,North Karelia,2019,37.1,7.9,37.3,8.5,37.2,8.2,325.9,368.7,347.5,14918,47776,20123,14413,45392,23536,29331,93168,43659,164465,2080.7
195,North Karelia,2020,35.8,8.2,36.8,8.7,36.3,8.4,329.3,373.9,351.8,14590,47091,20643,14292,44643,23950,28882,91734,44593,163537,2190.4
196,North Ostrobothnia,1993,34.8,8.9,32.7,10.4,33.7,9.6,241.8,234.4,238.0,54062,112171,15988,51618,105244,25733,105680,217415,41721,359433,803.1
197,North Ostrobothnia,1994,36.0,9.3,32.9,10.7,34.5,10.0,247.4,240.3,243.8,54024,113147,16501,51543,105850,26284,105567,218997,42785,361751,743.5
198,North Ostrobothnia,1995,36.4,9.5,33.0,11.0,34.7,10.3,252.8,247.1,249.9,53992,114027,17071,51608,106487,26756,105600,220514,43827,364443,796.4
199,North Ostrobothnia,1996,36.7,9.5,33.6,10.6,35.1,10.0,258.0,253.9,255.9,53699,114756,17589,51403,107141,27205,105102,221897,44794,366218,845.6
200,North Ostrobothnia,1997,38.8,9.4,34.4,10.7,36.6,10.0,263.2,260.9,262.0,53423,115337,18051,51017,107691,27463,104440,223028,45514,367361,887.7
201,North Ostrobothnia,1998,40.3,9.0,35.2,10.0,37.8,9.5,268.2,267.5,267.9,53032,116009,18353,50576,108315,27647,103608,224324,46000,368302,882.2
202,North Ostrobothnia,1999,41.2,8.8,36.3,9.7,38.8,9.2,273.5,274.3,273.9,52859,116936,18737,50146,108857,27952,103005,225793,46689,369827,911.4
203,North Ostrobothnia,2000,42.7,8.6,37.2,9.5,40.0,9.1,278.9,281.7,280.4,52728,118262,19213,50034,109921,28344,102762,228183,47557,372639,930.7
204,North Ostrobothnia,2001,41.9,8.7,37.3,9.5,39.6,9.1,283.5,288.5,286.0,52297,119555,19658,49733,111061,28699,102030,230616,48357,375182,985.7
205,North Ostrobothnia,2002,41.7,9.3,37.7,9.7,39.7,9.5,288.1,294.3,291.2,52056,120464,20183,49337,111787,29015,101393,232251,49198,377045,1085.6
206,North Ostrobothnia,2003,42.0,9.1,38.1,9.4,40.0,9.2,292.5,301.5,297.0,51682,121075,20801,49029,112360,29446,100711,233435,50247,378903,1159.7
207,North Ostrobothnia,2004,42.1,9.2,38.2,9.6,40.2,9.4,297.6,308.3,303.0,51814,121604,21421,49081,113093,30091,100895,234697,51512,381792,1216.2
208,North Ostrobothnia,2005,41.9,9.5,37.7,10.0,39.8,9.7,302.0,314.7,308.4,52089,122424,21798,49366,114045,30447,101455,236469,52245,384808,1268.6
209,North Ostrobothnia,2006,42.8,9.4,38.3,9.8,40.6,9.6,306.8,321.5,314.2,52328,122311,22888,49615,114059,31402,101943,236370,54290,387320,1342.8
210,North Ostrobothnia,2007,43.3,9.2,39.0,9.7,41.2,9.4,310.9,328.2,319.5,52677,123320,23203,49842,114977,31614,102519,238297,54817,390038,1390.7
211,North Ostrobothnia,2008,42.4,8.9,39.7,9.4,41.0,9.1,316.4,336.6,326.5,52742,124018,23819,49915,115441,32168,102657,239459,55987,392652,1497.1
212,North Ostrobothnia,2009,40.3,9.2,38.4,9.7,39.3,9.5,320.7,342.4,331.6,52926,124792,24379,50258,116233,32552,103184,241025,56931,395510,1578.2
213,North Ostrobothnia,2010,41.1,9.2,39.0,9.6,40.1,9.4,325.1,348.4,336.8,53093,125025,25413,50400,116584,33480,103493,241609,58893,398335,1637.7
214,North Ostrobothnia,2011,41.5,8.9,39.4,9.2,40.5,9.0,328.8,353.4,341.1,53224,125014,26654,50473,116746,34693,103697,241760,61347,401201,1710.6
215,North Ostrobothnia,2012,40.3,9.0,39.2,9.1,39.7,9.1,332.8,359.3,346.1,53430,125047,27910,50562,116541,35882,103992,241588,63792,403920,1782.8
216,North Ostrobothnia,2013,39.4,9.0,38.6,9.0,39.0,9.0,337.7,365.8,351.7,53627,124926,29195,50622,116522,37131,104249,241448,66326,406480,1870.1
217,North Ostrobothnia,2014,38.6,9.0,38.1,8.8,38.3,8.9,342.1,371.8,357.0,53552,124519,30595,50552,116106,38369,104104,240625,68964,408537,1872.8
218,North Ostrobothnia,2015,38.6,9.0,37.7,8.7,38.2,8.8,344.9,376.4,360.6,53377,124243,31973,50473,115637,39553,103850,239880,71526,410054,1895.1
219,North Ostrobothnia,2016,39.2,8.7,37.7,8.4,38.5,8.6,348.6,381.6,365.1,53126,123786,33263,50339,115077,40626,103465,238863,73889,411150,1929.5
220,North Ostrobothnia,2017,40.4,8.6,38.5,8.4,39.4,8.5,353.1,387.8,370.3,52902,123401,34541,50039,114312,41921,102941,237713,76462,411856,1963.3
221,North Ostrobothnia,2018,41.4,8.3,39.5,8.2,40.5,8.3,359.0,395.5,377.2,52133,123091,35706,49652,113755,42979,101785,236846,78685,412161,2001.6
222,North Ostrobothnia,2019,41.1,8.5,39.5,8.4,40.3,8.4,362.5,400.4,381.3,51350,122805,36903,49253,113421,44162,100603,236226,81065,412830,2121.4
223,North Ostrobothnia,2020,40.0,8.7,39.2,8.7,39.6,8.7,366.3,405.6,385.9,51028,122557,38043,48883,113263,45351,99911,235820,83394,413830,2206.6
224,North Savo,1993,34.9,8.3,32.3,9.4,33.6,8.8,224.3,224.2,224.3,33379,84809,14525,32277,80363,25067,65656,165172,39592,266956,865.9
225,North Savo,1994,35.9,8.5,32.5,9.6,34.1,9.0,228.3,230.0,229.2,33219,84608,14997,32148,80192,25391,65367,164800,40388,266870,857.5
226,North Savo,1995,35.8,8.7,32.2,9.8,34.0,9.2,232.6,236.2,234.4,32845,84259,15405,31784,79867,25742,64629,164126,41147,266308,849.5
227,North Savo,1996,35.6,8.5,32.8,9.3,34.2,8.9,236.9,242.4,239.7,32481,83920,15791,31356,79519,25977,63837,163439,41768,265644,897.6
228,North Savo,1997,37.1,8.7,33.5,9.4,35.3,9.1,240.8,247.9,244.5,32149,83412,16128,31030,79188,26209,63179,162600,42337,264578,973.5
229,North Savo,1998,38.9,8.2,34.4,9.0,36.6,8.6,244.6,253.0,248.9,31656,82933,16326,30519,78729,26265,62175,161662,42591,262946,986.7
230,North Savo,1999,39.2,8.0,35.3,8.7,37.2,8.3,248.2,258.4,253.5,31135,82491,16653,30044,78256,26411,61179,160747,43064,261393,981.9
231,North Savo,2000,39.7,7.9,35.5,8.6,37.6,8.2,251.8,263.7,257.9,30539,81940,16932,29547,77568,26613,60086,159508,43545,259639,1002.9
232,North Savo,2001,39.8,7.8,36.1,8.4,37.9,8.1,255.9,269.4,262.9,30121,81690,17181,29158,77437,26779,59279,159127,43960,258664,1059.1
233,North Savo,2002,40.2,8.2,36.5,8.7,38.3,8.4,260.5,274.4,267.6,29466,81670,17442,28514,77318,26973,57980,158988,44415,257728,1167.0
234,North Savo,2003,40.7,8.2,36.8,8.5,38.7,8.3,265.0,280.6,273.0,28918,81456,17887,27920,77046,27259,56838,158502,45146,257079,1223.1
235,North Savo,2004,40.8,8.0,37.1,8.6,38.9,8.3,269.1,286.6,278.1,28611,81139,18379,27496,76836,27583,56107,157975,45962,256740,1326.2
236,North Savo,2005,40.8,8.4,37.1,8.8,38.9,8.6,273.1,292.6,283.1,28145,80782,18586,27123,76485,27709,55268,157267,46295,255683,1404.9
237,North Savo,2006,41.6,8.2,37.8,8.9,39.7,8.6,277.5,299.2,288.6,27856,80418,19257,26815,75941,28235,54671,156359,47492,255094,1466.2
238,North Savo,2007,42.4,7.9,38.8,8.7,40.6,8.3,281.9,305.4,293.9,27336,80319,19356,26427,76064,28112,53763,156383,47468,254367,1567.6
239,North Savo,2008,41.6,7.7,39.3,8.3,40.4,8.0,286.6,312.9,300.1,27113,80050,19699,26039,75987,28302,53152,156037,48001,253899,1651.2
240,North Savo,2009,39.2,8.1,38.7,8.4,38.9,8.3,290.7,318.8,305.1,26830,79992,20022,25622,75920,28552,52452,155912,48574,253605,1743.1
241,North Savo,2010,40.4,8.0,39.1,8.4,39.7,8.2,295.2,324.4,310.1,26464,79436,20755,25306,75617,29009,51770,155053,49764,253337,1776.6
242,North Savo,2011,41.0,7.8,39.5,8.1,40.3,7.9,299.0,330.4,315.0,26239,78870,21692,25015,75008,29756,51254,153878,51448,253472,1895.9
243,North Savo,2012,40.5,7.7,39.7,7.8,40.1,7.8,303.3,336.0,320.0,25986,78338,22544,24870,74582,30378,50856,152920,52922,253524,2021.5
244,North Savo,2013,39.5,7.8,39.3,7.7,39.4,7.8,308.8,343.2,326.3,25692,77599,23506,24584,74176,31103,50276,151775,54609,253643,2125.2
245,North Savo,2014,38.8,7.7,38.8,7.6,38.8,7.6,313.4,349.2,331.6,25436,77047,24404,24315,73490,31789,49751,150537,56193,253584,2132.8
246,North Savo,2015,38.4,7.6,38.4,7.6,38.4,7.6,316.0,354.5,335.6,25243,76321,25271,24141,72882,32268,49384,149203,57539,253239,2155.3
247,North Savo,2016,39.0,7.6,38.7,7.7,38.9,7.6,320.2,360.5,340.7,25012,75520,26009,23917,72269,32827,48929,147789,58836,252815,2176.9
248,North Savo,2017,39.8,7.5,39.3,7.5,39.6,7.5,324.6,367.2,346.3,24689,74416,26843,23596,71292,33488,48285,145708,60331,251570,2197.5
249,North Savo,2018,40.4,7.2,39.8,7.3,40.1,7.2,330.1,375.0,352.9,24382,73435,27561,23276,70386,34094,47658,143821,61655,250414,2213.8
250,North Savo,2019,40.4,7.2,40.1,7.4,40.2,7.3,333.6,380.5,357.4,23866,72441,28326,22935,69543,34663,46801,141984,62989,249003,2362.8
251,North Savo,2020,38.8,7.4,39.3,7.5,39.1,7.5,337.0,385.8,361.9,23492,71573,29063,22515,68892,35288,46007,140465,64351,248265,2474.1
252,Ostrobothnia,1993,39.7,8.7,34.7,9.6,37.1,9.1,231.9,217.4,224.4,21938,51321,10732,20552,49486,16941,42490,100807,27673,168698,822.0
253,Ostrobothnia,1994,41.4,8.9,34.8,9.8,38.0,9.3,237.6,223.9,230.5,21869,51439,10855,20524,49321,17126,42393,100760,27981,168833,820.5
254,Ostrobothnia,1995,41.8,8.9,34.9,9.8,38.3,9.3,243.3,230.7,236.8,21780,51487,10957,20455,49313,17172,42235,100800,28129,168888,859.9
255,Ostrobothnia,1996,42.5,8.9,36.1,9.4,39.2,9.1,248.3,237.9,242.9,21715,51587,11152,20348,49415,17154,42063,101002,28306,169019,904.6
256,Ostrobothnia,1997,44.1,8.8,37.0,9.3,40.5,9.0,252.9,243.9,248.3,21471,51832,11273,20112,49396,17209,41583,101228,28482,168964,985.8
257,Ostrobothnia,1998,45.9,8.1,38.5,8.5,42.1,8.3,257.5,249.9,253.6,21291,51956,11439,19881,49392,17244,41172,101348,28683,168867,1028.3
258,Ostrobothnia,1999,45.6,7.8,38.8,8.2,42.1,8.0,261.0,255.6,258.2,21074,51870,11535,19613,49310,17218,40687,101180,28753,168326,1026.4
259,Ostrobothnia,2000,46.7,7.6,39.8,8.2,43.3,7.9,264.6,261.8,263.2,20829,51812,11713,19411,49351,17258,40240,101163,28971,168077,1067.4
260,Ostrobothnia,2001,46.6,7.6,40.3,8.0,43.4,7.8,268.8,267.4,268.1,20573,52062,11838,19208,49335,17280,39781,101397,29118,167986,1116.3
261,Ostrobothnia,2002,46.5,7.7,40.9,7.9,43.7,7.8,273.5,272.2,272.8,20380,52061,12000,19035,49209,17385,39415,101270,29385,167921,1187.2
262,Ostrobothnia,2003,46.6,7.8,41.2,7.9,43.9,7.9,277.4,279.0,278.2,20314,52090,12200,18933,49136,17546,39247,101226,29746,168046,1241.3
263,Ostrobothnia,2004,46.7,7.8,41.4,7.9,44.1,7.9,281.8,286.2,284.0,20179,52155,12462,18837,49200,17656,39016,101355,30118,168361,1304.1
264,Ostrobothnia,2005,46.4,8.4,41.3,8.4,43.9,8.4,285.2,292.4,288.9,20125,52343,12574,18749,49312,17583,38874,101655,30157,168583,1390.0
265,Ostrobothnia,2006,47.4,8.4,42.1,8.3,44.7,8.3,289.5,299.8,294.7,20087,52382,13007,18780,49129,17956,38867,101511,30963,169170,1418.8
266,Ostrobothnia,2007,48.5,7.9,43.0,8.0,45.7,8.0,293.6,307.6,300.7,20041,52737,13188,18829,49503,17941,38870,102240,31129,169971,1500.7
267,Ostrobothnia,2008,48.1,7.7,43.6,7.7,45.9,7.7,298.3,316.2,307.3,20104,53210,13450,18758,49746,18071,38862,102956,31521,170994,1626.6
268,Ostrobothnia,2009,45.1,8.3,42.8,8.0,43.9,8.1,302.5,322.8,312.8,20093,53586,13744,18723,49943,18259,38816,103529,32003,172085,1678.6
269,Ostrobothnia,2010,46.0,8.1,43.2,7.9,44.6,8.0,306.7,329.6,318.2,20049,53585,14318,18784,49843,18663,38833,103428,32981,172981,1675.5
270,Ostrobothnia,2011,46.5,7.9,43.7,7.6,45.1,7.7,310.2,336.1,323.2,20050,53510,15013,18889,49821,19171,38939,103331,34184,174170,1777.8
271,Ostrobothnia,2012,46.1,7.8,43.7,7.5,44.9,7.7,313.7,342.4,328.1,19915,53390,15553,18817,49777,19573,38732,103167,35126,174777,1898.8
272,Ostrobothnia,2013,45.4,7.7,43.3,7.2,44.4,7.5,319.3,350.3,334.8,19871,53386,16093,18783,49651,19940,38654,103037,36033,175530,2000.5
273,Ostrobothnia,2014,44.6,7.9,42.9,7.2,43.7,7.5,323.5,356.4,340.0,19875,53199,16654,18793,49559,20378,38668,102758,37032,176316,2050.0
274,Ostrobothnia,2015,43.8,7.9,42.3,7.2,43.1,7.6,326.2,361.5,343.8,19931,53083,17125,18705,49324,20737,38636,102407,37862,176894,2066.7
275,Ostrobothnia,2016,43.4,8.0,42.0,7.1,42.7,7.5,329.2,367.1,348.1,19909,52726,17498,18730,48801,21056,38639,101527,38554,176729,2003.3
276,Ostrobothnia,2017,44.6,7.8,42.5,7.0,43.6,7.4,335.1,375.9,355.5,19849,52288,17931,18709,48233,21287,38558,100521,39218,176272,1933.0
277,Ostrobothnia,2018,45.2,7.4,43.0,6.9,44.1,7.1,342.4,386.2,364.2,19718,52077,18263,18619,47911,21571,38337,99988,39834,176193,2034.7
278,Ostrobothnia,2019,44.9,7.8,43.1,7.0,44.0,7.4,345.3,391.4,368.2,19607,51735,18678,18462,47487,21871,38069,99222,40549,175923,2128.0
279,Ostrobothnia,2020,42.4,8.1,41.4,7.5,41.9,7.8,348.2,396.6,372.3,19437,51505,18938,18407,47342,22197,37844,98847,41135,175816,2147.5
280,Pirkanmaa,1993,38.5,7.9,33.7,8.6,36.0,8.2,252.6,225.9,238.5,51240,138158,23541,48811,136693,42596,100051,274851,66137,435789,655.4
281,Pirkanmaa,1994,40.2,8.2,34.2,8.8,37.1,8.5,257.5,232.3,244.2,51343,138925,24098,48932,137053,43212,100275,275978,67310,438114,649.2
282,Pirkanmaa,1995,41.0,8.4,34.5,9.0,37.6,8.7,263.2,239.0,250.5,51394,139678,24752,49018,137591,43725,100412,277269,68477,440734,698.2
283,Pirkanmaa,1996,41.2,8.0,34.8,8.5,37.9,8.3,268.3,245.6,256.4,51256,140527,25320,48902,138186,44056,100158,278713,69376,443065,732.7
284,Pirkanmaa,1997,43.0,8.1,36.0,8.8,39.4,8.4,273.5,252.2,262.4,51327,141498,25776,49025,138842,44279,100352,280340,70055,445536,786.4
285,Pirkanmaa,1998,44.9,7.4,37.9,7.9,41.3,7.7,279.0,258.5,268.3,51373,142480,26196,49052,139692,44464,100425,282172,70660,448045,828.8
286,Pirkanmaa,1999,45.4,7.3,38.5,7.7,41.9,7.5,283.9,265.4,274.2,51293,143504,26600,49192,140649,44648,100485,284153,71248,450548,846.8
287,Pirkanmaa,2000,46.4,7.3,39.4,7.6,42.8,7.5,288.7,272.0,280.0,51299,144816,27092,49097,141792,44814,100396,286608,71906,453319,872.2
288,Pirkanmaa,2001,46.1,7.3,39.8,7.6,42.9,7.4,293.4,278.9,285.9,51173,146329,27735,49038,143250,45070,100211,289579,72805,456934,930.6
289,Pirkanmaa,2002,45.9,7.6,40.2,7.7,43.0,7.7,299.1,285.1,291.8,50966,147925,28254,48779,144306,45367,99745,292231,73621,460103,996.4
290,Pirkanmaa,2003,45.6,7.8,40.2,7.7,42.9,7.7,304.2,292.7,298.3,50879,148850,29089,48744,145186,45935,99623,294036,75024,463330,1060.3
291,Pirkanmaa,2004,46.0,7.8,40.7,7.6,43.3,7.7,308.8,299.7,304.1,51028,149949,29827,48942,146082,46694,99970,296031,76521,467424,1146.9
292,Pirkanmaa,2005,46.0,8.2,40.8,8.1,43.3,8.1,313.6,306.5,309.9,51352,151156,30434,49252,147340,47003,100604,298496,77437,471409,1211.9
293,Pirkanmaa,2006,47.0,8.0,41.7,8.0,44.3,8.0,319.0,314.3,316.6,51665,152150,31680,49713,148054,47983,101378,300204,79663,475645,1276.4
294,Pirkanmaa,2007,47.6,7.8,42.6,7.9,45.0,7.9,323.1,321.1,322.1,51850,153938,32184,49892,149790,48377,101742,303728,80561,480634,1358.2
295,Pirkanmaa,2008,46.5,7.8,42.9,7.6,44.7,7.7,328.6,330.1,329.4,52130,155148,33065,50155,150868,48997,102285,306016,82062,484638,1515.5
296,Pirkanmaa,2009,42.8,8.4,41.3,7.9,42.0,8.1,333.6,336.1,334.9,52351,155907,33989,50266,151683,49771,102617,307590,83760,488295,1529.1
297,Pirkanmaa,2010,43.8,8.4,41.8,7.9,42.8,8.1,339.4,343.1,341.3,52540,156222,35445,50501,151925,51005,103041,308147,86450,491746,1592.0
298,Pirkanmaa,2011,44.7,8.1,42.2,7.5,43.4,7.8,343.1,349.2,346.3,52576,156092,37290,50671,151617,52770,103247,307709,90060,495242,1692.2
299,Pirkanmaa,2012,43.6,8.1,42.1,7.4,42.8,7.7,347.6,356.2,352.0,52817,155842,39267,50921,151514,54483,103738,307356,93750,499006,1779.2
300,Pirkanmaa,2013,42.1,8.2,41.0,7.4,41.5,7.8,353.4,363.6,358.6,52954,155798,41178,50910,151175,56199,103864,306973,97377,502575,1850.3
301,Pirkanmaa,2014,41.0,8.1,40.6,7.5,40.8,7.8,358.1,370.0,364.2,53027,155515,42862,51010,151079,57732,104037,306594,100594,505755,1845.8
302,Pirkanmaa,2015,40.9,8.0,40.1,7.4,40.5,7.7,360.9,375.3,368.3,53057,155377,44385,51147,151017,58972,104204,306394,103357,508448,1777.9
303,Pirkanmaa,2016,41.2,8.1,40.1,7.5,40.6,7.8,364.7,381.0,373.0,53132,155625,45601,51232,150942,60383,104364,306567,105984,511642,1809.3
304,Pirkanmaa,2017,42.9,7.9,41.1,7.3,42.0,7.6,369.3,387.3,378.5,53094,155989,46876,51204,151023,61597,104298,307012,108473,514333,1844.5
305,Pirkanmaa,2018,44.0,7.7,42.1,7.3,43.1,7.5,376.4,396.0,386.4,52885,156532,48043,50904,151504,62801,103789,308036,110844,517333,1912.1
306,Pirkanmaa,2019,43.8,7.9,42.0,7.6,42.9,7.8,380.3,401.7,391.2,52566,157063,49142,50663,151757,64099,103229,308820,113241,519872,1940.1
307,Pirkanmaa,2020,42.1,8.2,41.1,8.1,41.6,8.2,384.6,408.0,396.6,52248,157678,50295,50368,152383,65185,102616,310061,115480,522852,2013.6
308,Päijät-Häme,1993,37.5,7.5,33.8,8.3,35.6,7.9,226.3,209.4,217.4,24446,65784,10463,23729,65191,19284,48175,130975,29747,206233,734.2
309,Päijät-Häme,1994,38.8,7.6,34.2,8.2,36.4,7.9,229.7,214.2,221.5,24354,65673,10748,23634,64921,19542,47988,130594,30290,206171,690.0
310,Päijät-Häme,1995,39.5,7.7,34.3,8.6,36.8,8.2,233.5,219.5,226.1,24258,65454,10976,23479,64612,19846,47737,130066,30822,205973,700.7
311,Päijät-Häme,1996,39.6,7.4,34.3,7.7,36.9,7.5,237.5,223.9,230.3,24048,65092,11196,23317,64266,20034,47365,129358,31230,205394,783.4
312,Päijät-Häme,1997,41.7,7.6,35.6,7.9,38.6,7.8,240.5,229.7,234.8,23870,65033,11417,23163,64303,20093,47033,129336,31510,205338,816.0
313,Päijät-Häme,1998,43.2,7.0,37.1,7.3,40.0,7.2,243.9,235.2,239.3,23602,65050,11509,23010,64322,20179,46612,129372,31688,205030,836.5
314,Päijät-Häme,1999,44.1,6.7,37.7,7.2,40.8,7.0,247.1,240.4,243.6,23328,65008,11719,22774,64195,20402,46102,129203,32121,204858,857.3
315,Päijät-Häme,2000,45.2,6.4,38.6,6.9,41.8,6.7,249.9,244.9,247.2,23182,64995,12089,22629,64023,20675,45811,129018,32764,204912,875.8
316,Päijät-Häme,2001,44.6,6.5,38.7,7.1,41.5,6.8,253.0,249.8,251.3,22891,65062,12394,22456,64043,20908,45347,129105,33302,205071,925.7
317,Päijät-Häme,2002,44.2,6.7,39.2,7.2,41.6,7.0,257.2,254.5,255.8,22646,65069,12796,22239,64148,21224,44885,129217,34020,205464,1007.7
318,Päijät-Häme,2003,44.2,6.6,39.2,7.0,41.6,6.8,260.6,260.3,260.5,22385,65006,13219,22002,64105,21592,44387,129111,34811,205755,1129.7
319,Päijät-Häme,2004,44.3,6.6,39.6,6.8,41.9,6.7,264.3,266.3,265.3,22257,64828,13726,21792,63912,21998,44049,128740,35724,206021,1212.3
320,Päijät-Häme,2005,44.0,7.2,38.6,7.4,41.2,7.3,268.1,271.6,269.9,22172,64582,14080,21673,63788,22290,43845,128370,36370,206240,1280.7
321,Päijät-Häme,2006,44.8,7.2,39.1,7.4,41.8,7.3,272.5,277.8,275.3,22139,64130,14790,21597,63212,23057,43736,127342,37847,206481,1307.8
322,Päijät-Häme,2007,45.7,7.0,40.4,7.1,42.9,7.1,276.9,283.9,280.6,22080,64409,15038,21516,63617,23163,43596,128026,38201,207269,1382.4
323,Päijät-Häme,2008,44.4,6.8,40.9,6.9,42.6,6.9,280.8,290.3,285.8,21991,64510,15545,21418,63697,23456,43409,128207,39001,207940,1576.2
324,Päijät-Häme,2009,40.9,7.2,39.5,7.2,40.2,7.2,284.2,295.8,290.3,21740,64439,16028,21292,63606,23832,43032,128045,39860,208314,1589.4
325,Päijät-Häme,2010,42.1,7.3,39.6,7.3,40.8,7.3,288.3,301.4,295.1,21603,64100,16806,21131,63379,24491,42734,127479,41297,208777,1626.2
326,Päijät-Häme,2011,42.4,6.9,40.1,7.1,41.2,7.0,291.8,307.4,299.9,21367,63571,17802,20789,62961,25362,42156,126532,43164,209238,1697.5
327,Päijät-Häme,2012,41.6,6.9,39.9,6.9,40.7,6.9,295.4,312.8,304.5,21186,62927,18780,20600,62466,26208,41786,125393,44988,209503,1818.2
328,Päijät-Häme,2013,40.3,7.0,38.8,7.1,39.5,7.0,299.9,319.0,309.9,20975,62117,19778,20308,61647,27107,41283,123764,46885,209405,1927.5
329,Päijät-Häme,2014,39.2,6.8,37.9,6.9,38.5,6.9,303.9,324.3,314.5,20783,61199,20638,20055,60819,27884,40838,122018,48522,208959,1867.0
330,Päijät-Häme,2015,38.9,6.8,37.7,6.9,38.3,6.9,305.2,327.9,317.0,20557,60421,21462,19826,59897,28692,40383,120318,50154,208525,1870.9
331,Päijät-Häme,2016,39.7,6.7,37.6,6.7,38.6,6.7,307.7,332.6,320.6,20499,60024,22140,19619,59190,29347,40118,119214,51487,208574,1895.8
332,Päijät-Häme,2017,40.1,6.7,37.8,6.7,38.9,6.7,311.5,337.7,325.1,20423,59367,22809,19410,58324,30068,39833,117691,52877,208048,1879.9
333,Päijät-Häme,2018,40.5,6.3,38.4,6.3,39.4,6.3,316.5,345.0,331.3,20136,58889,23328,19120,57552,30648,39256,116441,53976,207394,1935.6
334,Päijät-Häme,2019,40.2,6.4,38.3,6.4,39.2,6.4,319.1,349.6,334.9,19771,58140,23888,18788,56677,31242,38559,114817,55130,206315,2082.0
335,Päijät-Häme,2020,38.4,6.5,37.0,6.7,37.7,6.6,322.1,354.3,338.8,19533,57673,24415,18575,55999,31755,38108,113672,56170,205771,2062.7
336,Satakunta,1993,37.6,7.8,33.2,8.9,35.3,8.4,222.1,205.2,213.3,28779,76499,13515,27725,73885,23341,56504,150384,36856,240519,740.3
337,Satakunta,1994,39.7,7.9,33.2,9.0,36.4,8.5,226.3,210.8,218.2,28552,76280,13823,27488,73593,23568,56040,149873,37391,240028,734.9
338,Satakunta,1995,40.0,8.2,32.8,9.2,36.3,8.7,230.2,215.8,222.7,28306,75900,14107,27215,72998,23901,55521,148898,38008,239255,752.7
339,Satakunta,1996,39.4,8.2,33.2,9.0,36.2,8.6,233.8,221.3,227.3,28021,75295,14455,26876,72608,24028,54897,147903,38483,238057,803.8
340,Satakunta,1997,41.2,8.3,34.1,8.9,37.6,8.6,237.2,226.6,231.7,27562,74802,14740,26440,72140,24138,54002,146942,38878,236818,867.5
341,Satakunta,1998,42.8,7.6,35.3,8.1,39.0,7.9,240.8,231.3,235.9,27293,74482,14953,26061,71722,24191,53354,146204,39144,235662,912.4
342,Satakunta,1999,42.4,7.5,35.7,8.1,38.9,7.8,243.8,236.2,239.8,26933,73929,15214,25720,71175,24343,52653,145104,39557,234233,915.6
343,Satakunta,2000,43.8,7.3,36.4,7.8,40.0,7.5,246.7,241.1,243.8,26480,73385,15589,25175,70597,24512,51655,143982,40101,232569,916.1
344,Satakunta,2001,43.6,7.3,37.0,7.6,40.2,7.4,249.5,246.2,247.8,26029,72980,15972,24639,70059,24781,50668,143039,40753,231307,1007.9
345,Satakunta,2002,43.1,7.4,37.5,7.5,40.3,7.5,252.9,251.0,252.0,25524,72692,16384,24200,69788,24980,49724,142480,41364,230480,1065.7
346,Satakunta,2003,43.0,7.3,37.8,7.4,40.4,7.4,256.4,257.0,256.7,25170,72297,16820,23752,69423,25312,48922,141720,42132,229910,1140.1
347,Satakunta,2004,43.2,7.4,37.9,7.3,40.5,7.3,260.0,263.2,261.6,24860,71752,17327,23558,68892,25788,48418,140644,43115,229389,1216.0
348,Satakunta,2005,43.4,7.8,37.8,7.7,40.5,7.8,263.4,268.6,266.1,24628,71401,17607,23250,68443,26019,47878,139844,43626,228675,1289.8
349,Satakunta,2006,44.2,7.6,38.5,7.6,41.3,7.6,266.7,274.7,270.8,24413,70661,18286,23139,67751,26558,47552,138412,44844,228051,1366.5
350,Satakunta,2007,45.2,7.4,39.3,7.4,42.2,7.4,270.0,280.6,275.5,24119,70343,18449,22893,67551,26573,47012,137894,45022,227131,1398.1
351,Satakunta,2008,44.4,7.1,40.2,7.0,42.3,7.1,273.6,286.2,280.1,23782,70023,18790,22598,67175,26893,46380,137198,45683,226358,1528.7
352,Satakunta,2009,41.8,7.5,39.3,7.1,40.5,7.3,277.4,291.8,284.8,23494,69664,19268,22367,66874,27175,45861,136538,46443,226116,1622.1
353,Satakunta,2010,42.1,7.6,39.7,7.1,40.9,7.3,280.8,298.0,289.6,23350,69182,19925,22094,66331,27709,45444,135513,47634,225762,1652.4
354,Satakunta,2011,42.5,7.4,40.0,7.0,41.2,7.2,284.1,303.8,294.2,23091,68268,20774,21883,65468,28395,44974,133736,49169,225302,1786.4
355,Satakunta,2012,41.7,7.2,39.7,6.9,40.7,7.0,287.5,309.6,298.9,22978,67449,21699,21745,64639,29172,44723,132088,50871,224934,1873.5
356,Satakunta,2013,41.0,7.2,39.2,6.7,40.1,7.0,292.2,316.1,304.5,22701,66688,22569,21564,63848,29906,44265,130536,52475,224556,1902.8
357,Satakunta,2014,39.7,7.2,38.8,6.7,39.3,6.9,295.9,321.5,309.0,22480,65953,23412,21283,63045,30464,43763,128998,53876,223985,1935.3
358,Satakunta,2015,38.9,7.1,37.9,6.5,38.4,6.8,297.3,325.6,311.8,22114,65033,24082,21012,62007,31130,43126,127040,55212,222957,1945.4
359,Satakunta,2016,39.0,6.9,37.5,6.3,38.3,6.6,299.1,330.6,315.2,21881,64281,24703,20766,61015,31455,42647,125296,56158,221740,1930.7
360,Satakunta,2017,41.0,6.6,38.6,6.1,39.8,6.4,302.0,336.2,319.4,21588,63467,25293,20538,60029,31901,42126,123496,57194,220398,1897.3
361,Satakunta,2018,41.3,6.4,39.1,5.9,40.2,6.1,308.0,343.2,325.9,21229,62521,25777,20140,58958,32302,41369,121479,58079,218624,1978.5
362,Satakunta,2019,40.6,6.5,39.1,6.0,39.9,6.3,310.8,347.7,329.6,20772,61522,26217,19798,58013,32661,40570,119535,58878,216752,2051.6
363,Satakunta,2020,39.0,6.0,38.5,5.8,38.7,5.9,312.9,352.8,333.2,20491,60843,26638,19543,57208,32950,40034,118051,59588,215416,2081.8
364,South Karelia,1993,37.7,7.4,33.7,8.4,35.7,7.9,219.1,202.2,210.4,16008,45212,8086,15255,42696,14078,31263,87908,22164,139569,807.4
365,South Karelia,1994,38.2,8.0,33.3,8.4,35.7,8.2,222.7,207.2,214.7,15894,44999,8344,15131,42423,14267,31025,87422,22611,139297,804.9
366,South Karelia,1995,39.1,8.0,33.0,8.7,36.0,8.3,227.0,213.2,219.9,15797,44748,8544,14893,42006,14431,30690,86754,22975,138678,792.5
367,South Karelia,1996,38.4,7.8,33.1,8.1,35.7,8.0,231.1,217.9,224.3,15568,44565,8724,14747,41709,14554,30315,86274,23278,138163,867.6
368,South Karelia,1997,39.9,7.9,33.4,8.5,36.6,8.2,235.4,223.8,229.5,15391,44460,8881,14679,41578,14641,30070,86038,23522,137944,892.2
369,South Karelia,1998,41.2,7.6,34.8,7.7,38.0,7.6,238.9,228.9,233.8,15151,44290,8942,14441,41319,14779,29592,85609,23721,137238,917.1
370,South Karelia,1999,41.6,7.5,35.2,7.5,38.4,7.5,242.9,234.1,238.4,14899,44069,9077,14244,41014,14859,29143,85083,23936,136525,915.3
371,South Karelia,2000,43.5,7.3,36.1,7.2,39.7,7.3,246.7,239.4,243.0,14785,43899,9273,14068,40912,15019,28853,84811,24292,136299,941.0
372,South Karelia,2001,42.3,7.4,36.5,7.1,39.4,7.3,251.1,245.6,248.3,14651,43968,9497,13904,40790,15119,28555,84758,24616,136161,1016.6
373,South Karelia,2002,42.1,7.6,36.8,7.2,39.4,7.4,255.7,251.0,253.3,14336,43874,9692,13613,40655,15285,27949,84529,24977,135840,1091.3
374,South Karelia,2003,42.1,7.9,36.9,7.3,39.4,7.6,260.0,257.8,258.9,14146,43664,9961,13412,40464,15431,27558,84128,25392,135458,1173.0
375,South Karelia,2004,42.4,8.0,37.0,7.1,39.7,7.5,264.7,264.2,264.4,13915,43319,10244,13220,40163,15633,27135,83482,25877,134962,1229.9
376,South Karelia,2005,42.4,8.3,36.8,7.8,39.6,8.0,269.3,270.3,269.8,13787,43168,10407,13142,40104,15701,26929,83272,26108,134790,1309.6
377,South Karelia,2006,42.7,8.4,37.5,7.6,40.1,8.0,273.3,276.8,275.1,13680,42743,10907,12991,39633,16111,26671,82376,27018,134441,1361.6
378,South Karelia,2007,43.5,8.2,38.1,7.5,40.8,7.8,277.3,282.8,280.1,13446,42700,10931,12859,39446,16119,26305,82146,27050,133899,1456.4
379,South Karelia,2008,42.4,8.1,38.9,7.2,40.7,7.6,281.0,290.1,285.6,13243,42556,11190,12712,39309,16248,25955,81865,27438,133647,1593.3
380,South Karelia,2009,39.7,8.6,38.0,7.5,38.8,8.0,285.2,296.6,291.0,13022,42383,11396,12526,39072,16384,25548,81455,27780,133210,1656.0
381,South Karelia,2010,40.6,8.2,38.5,7.1,39.5,7.6,289.6,302.9,296.4,12890,42084,11779,12407,38763,16676,25297,80847,28455,132899,1809.9
382,South Karelia,2011,41.3,7.8,39.0,6.9,40.1,7.3,293.1,308.3,300.8,12631,41517,12273,12245,38327,17071,24876,79844,29344,132527,1825.4
383,South Karelia,2012,40.8,7.7,39.0,6.8,39.9,7.2,297.1,313.9,305.6,12484,41053,12796,12157,37929,17537,24641,78982,30333,132355,1869.2
384,South Karelia,2013,40.2,7.6,38.5,6.8,39.4,7.2,302.1,320.4,311.4,12302,40655,13286,11987,37521,17972,24289,78176,31258,132252,1921.7
385,South Karelia,2014,39.4,7.6,37.9,6.8,38.6,7.2,306.9,326.1,316.6,12141,40127,13725,11887,37061,18303,24028,77188,32028,131764,2047.4
386,South Karelia,2015,38.4,7.6,37.2,6.5,37.8,7.0,309.3,330.7,320.1,12015,39609,14102,11664,36559,18638,23679,76168,32740,131155,1994.6
387,South Karelia,2016,38.6,7.7,36.8,6.5,37.7,7.1,313.1,335.7,324.6,11834,39143,14444,11464,36100,18828,23298,75243,33272,130506,2044.2
388,South Karelia,2017,39.2,7.9,37.5,6.5,38.4,7.2,317.7,341.7,329.9,11705,38648,14751,11307,35599,19165,23012,74247,33916,129865,2039.8
389,South Karelia,2018,40.0,7.5,38.1,6.2,39.1,6.9,325.7,351.2,338.6,11455,38100,15049,11043,34964,19418,22498,73064,34467,128756,2075.2
390,South Karelia,2019,39.2,7.6,37.9,6.5,38.5,7.0,328.7,356.6,342.8,11223,37699,15345,10788,34367,19638,22011,72066,34983,127757,2039.3
391,South Karelia,2020,38.1,7.8,36.7,6.9,37.4,7.3,333.3,362.7,348.1,10949,37305,15590,10520,33913,19899,21469,71218,35489,126921,2295.6
392,South Ostrobothnia,1993,36.6,8.3,31.5,9.2,34.0,8.7,202.2,202.2,202.2,27740,63326,12704,26372,59856,20812,54112,123182,33516,207862,753.6
393,South Ostrobothnia,1994,38.3,8.5,31.8,9.5,35.0,9.0,206.8,208.0,207.4,27584,63292,12928,26187,59489,21042,53771,122781,33970,207514,735.7
394,South Ostrobothnia,1995,38.4,8.5,31.5,9.6,34.9,9.1,210.6,213.2,211.9,27119,62951,13101,25820,58916,21207,52939,121867,34308,206136,772.2
395,South Ostrobothnia,1996,38.7,8.6,32.1,9.4,35.4,9.0,214.3,217.9,216.1,26687,62615,13296,25558,58565,21325,52245,121180,34621,205108,848.4
396,South Ostrobothnia,1997,40.8,8.6,33.2,9.6,37.0,9.1,218.2,223.5,220.9,26336,62228,13524,25113,58160,21476,51449,120388,35000,203907,894.3
397,South Ostrobothnia,1998,42.6,7.9,34.8,8.7,38.6,8.3,222.1,229.6,226.0,26042,62025,13594,24701,58014,21524,50743,120039,35118,202935,911.0
398,South Ostrobothnia,1999,42.8,7.8,35.1,8.3,38.9,8.1,225.9,235.5,230.8,25670,61833,13761,24328,57778,21572,49998,119611,35333,202002,964.9
399,South Ostrobothnia,2000,43.9,7.7,36.1,8.2,40.0,8.0,229.6,240.4,235.2,25327,61572,13959,23868,57363,21638,49195,118935,35597,200766,984.0
400,South Ostrobothnia,2001,43.4,7.4,36.1,8.1,39.7,7.7,232.5,245.8,239.3,24981,61221,14128,23499,57172,21727,48480,118393,35855,199639,1087.5
401,South Ostrobothnia,2002,43.3,7.8,37.0,7.9,40.1,7.8,236.6,250.2,243.5,24564,61319,14315,23033,57132,21804,47597,118451,36119,199190,1125.4
402,South Ostrobothnia,2003,43.6,7.7,37.5,8.0,40.5,7.8,241.0,256.6,248.9,24167,61369,14532,22712,57135,21915,46879,118504,36447,199019,1202.5
403,South Ostrobothnia,2004,43.7,7.7,37.6,8.0,40.6,7.9,245.1,262.8,254.2,23906,61253,14930,22486,57082,22138,46392,118335,37068,199150,1294.0
404,South Ostrobothnia,2005,44.1,8.0,37.7,8.3,40.9,8.1,249.9,269.2,259.7,23721,61216,15008,22280,57114,22096,46001,118330,37104,198856,1366.3
405,South Ostrobothnia,2006,45.1,7.9,38.5,8.1,41.8,8.0,254.5,275.8,265.4,23519,60945,15397,22184,56826,22458,45703,117771,37855,198626,1422.8
406,South Ostrobothnia,2007,45.7,7.6,39.2,7.8,42.4,7.7,258.6,282.0,270.5,23443,61161,15442,21962,57121,22354,45405,118282,37796,198831,1507.2
407,South Ostrobothnia,2008,44.4,7.5,39.7,7.6,42.0,7.6,263.2,289.0,276.4,23287,61109,15642,21806,56987,22416,45093,118096,38058,198502,1595.7
408,South Ostrobothnia,2009,41.8,7.8,39.0,7.8,40.4,7.8,267.7,295.1,281.6,23061,61059,15896,21707,56955,22511,44768,118014,38407,198477,1677.2
409,South Ostrobothnia,2010,43.2,7.5,39.7,7.6,41.4,7.6,271.9,301.2,286.8,22892,60711,16448,21627,56752,22758,44519,117463,39206,198469,1688.2
410,South Ostrobothnia,2011,43.4,7.2,40.1,7.3,41.8,7.3,275.9,307.6,292.0,22683,60274,17130,21540,56415,23263,44223,116689,40393,198671,1814.1
411,South Ostrobothnia,2012,42.6,7.0,40.0,7.2,41.3,7.1,279.5,314.0,297.0,22674,59751,17867,21493,55987,23789,44167,115738,41656,198944,1869.3
412,South Ostrobothnia,2013,41.6,7.0,39.8,6.9,40.7,7.0,283.8,320.4,302.4,22549,59084,18639,21271,55351,24387,43820,114435,43026,198831,2013.1
413,South Ostrobothnia,2014,40.5,7.1,39.4,6.8,39.9,6.9,287.9,326.3,307.4,22376,58347,19224,21060,54695,24935,43436,113042,44159,198241,2078.3
414,South Ostrobothnia,2015,40.1,7.0,38.9,6.6,39.5,6.8,290.3,330.9,310.9,22198,57426,19867,20894,53928,25417,43092,111354,45284,197371,2050.2
415,South Ostrobothnia,2016,40.6,6.9,38.7,6.6,39.7,6.7,294.5,337.0,316.0,21966,56645,20470,20803,53304,25699,42769,109949,46169,196572,2007.8
416,South Ostrobothnia,2017,41.5,6.7,39.2,6.5,40.3,6.6,298.8,343.3,321.4,21722,55777,21044,20636,52534,26164,42358,108311,47208,195583,2047.8
417,South Ostrobothnia,2018,41.9,6.6,40.0,6.3,40.9,6.5,303.2,350.1,326.9,21455,55078,21613,20242,51801,26456,41697,106879,48069,194316,2096.0
418,South Ostrobothnia,2019,41.5,6.6,40.4,6.2,40.9,6.4,306.6,355.6,331.4,21139,54336,22192,19998,50978,26903,41137,105314,49095,193207,2245.9
419,South Ostrobothnia,2020,40.3,6.8,39.5,6.4,39.9,6.6,310.3,361.1,335.9,20714,53688,22742,19665,50297,27261,40379,103985,50003,192150,2309.1
420,South Savo,1993,35.5,7.8,32.4,8.9,33.9,8.4,208.3,211.4,209.9,19092,51762,9826,18422,49441,16707,37514,101203,26533,163130,806.0
421,South Savo,1994,36.2,8.3,32.3,9.3,34.2,8.8,211.4,216.3,214.0,18912,51507,10141,18230,49131,16989,37142,100638,27130,162691,798.7
422,South Savo,1995,36.2,8.2,32.3,9.4,34.2,8.8,215.6,221.7,218.7,18642,51122,10414,17914,48753,17267,36556,99875,27681,162033,820.1
423,South Savo,1996,36.0,8.1,32.3,9.0,34.1,8.5,219.5,226.7,223.2,18385,50655,10619,17732,48273,17462,36117,98928,28081,161128,868.0
424,South Savo,1997,37.5,8.3,32.9,9.4,35.1,8.9,223.1,231.5,227.4,18126,50078,10902,17454,47858,17642,35580,97936,28544,160077,926.5
425,South Savo,1998,38.8,7.8,34.2,8.5,36.5,8.2,226.6,236.8,231.9,17758,49487,11076,17147,47413,17746,34905,96900,28822,158725,960.2
426,South Savo,1999,39.3,7.7,34.7,8.6,36.9,8.2,229.2,241.0,235.3,17557,48934,11231,16822,46868,17911,34379,95802,29142,157334,998.8
427,South Savo,2000,39.5,7.6,35.1,8.2,37.2,7.9,232.1,246.1,239.3,17230,48397,11527,16531,46385,18095,33761,94782,29622,156117,1006.5
428,South Savo,2001,39.9,7.6,35.5,8.2,37.6,7.9,235.5,251.2,243.6,16859,48087,11759,16199,45975,18212,33058,94062,29971,154978,1109.7
429,South Savo,2002,39.6,7.5,36.2,8.0,37.8,7.8,239.1,256.1,247.9,16395,47729,12047,15751,45639,18391,32146,93368,30438,153864,1192.2
430,South Savo,2003,39.8,7.5,36.5,7.8,38.1,7.7,243.0,261.8,252.8,16072,47333,12399,15337,45196,18629,31409,92529,31028,152965,1265.7
431,South Savo,2004,40.0,7.5,36.2,7.9,38.0,7.7,246.9,267.2,257.4,15681,47013,12688,15077,44724,18902,30758,91737,31590,152171,1327.6
432,South Savo,2005,39.8,7.8,36.1,8.2,37.9,8.0,250.8,272.7,262.1,15371,46696,12832,14804,44520,18952,30175,91216,31784,151395,1421.6
433,South Savo,2006,41.0,7.6,37.0,8.1,39.0,7.9,254.6,278.6,267.0,15177,46140,13281,14584,43926,19275,29761,90066,32556,150471,1518.9
434,South Savo,2007,41.7,7.4,37.8,7.6,39.7,7.5,258.2,283.8,271.4,14814,45807,13337,14224,43518,19243,29038,89325,32580,149032,1582.7
435,South Savo,2008,40.8,7.1,38.2,7.4,39.5,7.2,262.6,290.1,276.8,14498,45283,13628,13912,43165,19326,28410,88448,32954,147892,1756.7
436,South Savo,2009,38.7,7.2,38.0,7.2,38.4,7.2,266.1,296.0,281.5,14150,44830,13929,13560,42923,19411,27710,87753,33340,146979,1764.2
437,South Savo,2010,39.5,7.3,38.3,7.2,38.9,7.3,270.8,301.4,286.6,13882,44317,14360,13238,42407,19703,27120,86724,34063,146166,1848.1
438,South Savo,2011,39.5,7.1,38.5,7.0,39.0,7.0,274.9,307.4,291.6,13654,43699,14828,12992,41683,20170,26646,85382,34998,145353,2009.0
439,South Savo,2012,38.8,7.1,38.5,6.9,38.6,7.0,279.0,313.7,296.8,13364,42977,15402,12722,40924,20729,26086,83901,36131,144393,2060.5
440,South Savo,2013,38.0,7.0,37.8,6.9,37.9,7.0,283.8,320.1,302.5,13104,42210,16000,12464,40372,21139,25568,82582,37139,143638,2173.1
441,South Savo,2014,37.5,6.9,37.5,6.7,37.5,6.8,288.1,326.4,307.8,12881,41485,16498,12201,39758,21529,25082,81243,38027,142744,2238.4
442,South Savo,2015,36.4,7.0,36.6,6.7,36.5,6.9,290.7,330.4,311.1,12670,40749,16920,11953,38952,21906,24623,79701,38826,141621,2236.0
443,South Savo,2016,37.2,6.8,36.9,6.5,37.0,6.6,293.9,335.4,315.3,12472,40015,17316,11746,38209,22188,24218,78224,39504,140422,2249.8
444,South Savo,2017,37.6,6.7,37.1,6.4,37.4,6.6,298.5,341.8,320.8,12148,39105,17767,11488,37289,22505,23636,76394,40272,138822,2262.6
445,South Savo,2018,38.2,6.4,37.7,5.8,38.0,6.1,302.2,348.2,325.7,11774,38043,18183,11176,36049,22665,22950,74092,40848,136474,2310.4
446,South Savo,2019,37.8,6.4,37.3,5.9,37.6,6.1,305.2,352.7,329.5,11411,37005,18541,10881,34952,22906,22292,71957,41447,134314,2403.4
447,South Savo,2020,36.5,6.4,36.7,6.0,36.6,6.2,307.9,357.9,333.4,11127,36196,18929,10565,34041,23166,21692,70237,42095,132702,2550.6
448,Southwest Finland,1993,39.6,7.7,36.4,8.4,37.9,8.1,249.7,224.9,236.6,50345,135203,24281,48386,134613,42926,98731,269816,67207,430409,713.4
449,Southwest Finland,1994,41.5,8.2,36.8,8.7,39.1,8.5,254.5,231.2,242.2,50336,135778,24820,48332,135194,43493,98668,270972,68313,432603,704.9
450,Southwest Finland,1995,42.2,8.3,37.1,9.1,39.5,8.7,260.2,238.0,248.5,50317,136578,25403,48373,136068,43901,98690,272646,69304,435119,722.1
451,Southwest Finland,1996,42.2,8.4,37.6,9.0,39.8,8.7,264.5,244.3,253.9,50233,137339,25958,48191,136934,44198,98424,274273,70156,437491,766.8
452,Southwest Finland,1997,44.1,8.1,38.9,8.8,41.4,8.5,269.1,251.0,259.6,50293,138141,26333,48024,137842,44522,98317,275983,70855,439973,834.9
453,Southwest Finland,1998,45.7,7.4,40.2,7.9,42.9,7.7,273.1,256.9,264.6,50448,139307,26610,48082,139094,44760,98530,278401,71370,443050,860.6
454,Southwest Finland,1999,46.0,7.1,40.9,7.6,43.4,7.4,277.3,262.6,269.6,50432,140275,26904,48189,140059,45034,98621,280334,71938,445542,878.7
455,Southwest Finland,2000,47.2,7.2,41.6,7.8,44.3,7.5,280.8,268.6,274.4,50283,140887,27369,48024,140853,45167,98307,281740,72536,447103,900.9
456,Southwest Finland,2001,46.6,7.2,41.9,7.4,44.1,7.3,284.5,274.4,279.2,50124,141710,27869,47756,141906,45494,97880,283616,73363,449293,972.1
457,Southwest Finland,2002,46.2,7.6,41.9,7.9,44.0,7.8,288.8,280.1,284.2,49826,142228,28485,47330,142750,45689,97156,284978,74174,450969,1022.3
458,Southwest Finland,2003,45.4,7.7,42.0,7.8,43.6,7.8,292.9,286.8,289.7,49537,142401,29228,47054,143259,46148,96591,285660,75376,452444,1097.0
459,Southwest Finland,2004,45.9,7.6,42.3,7.7,44.0,7.6,297.0,293.3,295.1,49459,142442,30067,46793,143352,46676,96252,285794,76743,453745,1187.6
460,Southwest Finland,2005,46.5,8.0,42.4,8.2,44.4,8.1,300.8,299.6,300.2,49367,143042,30568,46706,143971,46898,96073,287013,77466,455584,1262.5
461,Southwest Finland,2006,47.2,7.9,43.1,8.2,45.1,8.1,305.0,306.7,305.9,49376,143218,31709,46846,144081,47949,96222,287299,79658,457789,1337.6
462,Southwest Finland,2007,47.8,7.7,43.8,8.0,45.8,7.8,308.8,313.5,311.2,49023,143900,32150,46801,144683,47951,95824,288583,80101,459235,1409.1
463,Southwest Finland,2008,47.2,7.6,44.1,7.7,45.6,7.7,313.8,322.4,318.2,49003,144305,33061,46763,145041,48426,95766,289346,81487,461177,1531.6
464,Southwest Finland,2009,43.9,7.9,42.9,7.8,43.4,7.9,317.3,328.3,323.0,48818,144544,34111,46623,145110,49207,95441,289654,83318,462914,1521.5
465,Southwest Finland,2010,43.8,8.0,43.1,7.8,43.4,7.9,321.0,334.1,327.8,48790,144433,35646,46579,144798,50517,95369,289231,86163,465183,1596.0
466,Southwest Finland,2011,44.5,7.8,43.2,7.6,43.9,7.7,324.3,340.1,332.5,48601,143767,37568,46354,144155,52260,94955,287922,89828,467217,1681.3
467,Southwest Finland,2012,43.3,7.9,42.7,7.7,43.0,7.8,327.5,346.2,337.2,48446,142947,39522,46131,143529,53939,94577,286476,93461,468936,1741.9
468,Southwest Finland,2013,42.4,8.0,41.8,7.6,42.1,7.8,332.3,353.0,343.1,48283,142464,41318,45841,142838,55552,94124,285302,96870,470880,1807.2
469,Southwest Finland,2014,41.6,7.9,41.3,7.6,41.4,7.8,336.2,358.6,347.8,48016,142139,42875,45681,142301,57010,93697,284440,99885,472726,1849.9
470,Southwest Finland,2015,41.2,7.9,40.9,7.4,41.0,7.7,338.2,363.5,351.3,47825,141756,44368,45458,141692,58437,93283,283448,102805,474323,1867.8
471,Southwest Finland,2016,41.9,7.7,40.8,7.3,41.3,7.5,341.2,369.6,355.9,47412,141743,45537,45155,141175,59566,92567,282918,105103,475543,1876.7
472,Southwest Finland,2017,43.5,7.5,41.6,7.3,42.5,7.4,345.9,376.6,361.8,47111,142251,46747,45066,140853,60868,92177,283104,107615,477677,1882.8
473,Southwest Finland,2018,44.2,7.4,42.5,7.1,43.3,7.3,352.9,386.0,370.0,46670,142290,47759,44571,140473,61890,91241,282763,109649,478582,1946.1
474,Southwest Finland,2019,43.9,7.5,42.5,7.4,43.2,7.4,356.4,391.6,374.6,46271,142062,48743,44055,140008,63072,90326,282070,111815,479341,1989.1
475,Southwest Finland,2020,41.4,7.7,41.4,7.7,41.4,7.7,359.4,397.5,379.0,46021,142396,49924,43750,139933,64195,89771,282329,114119,481403,2022.4
476,Uusimaa,1993,42.6,7.7,42.2,8.0,42.4,7.9,307.8,272.4,288.9,153908,413542,49631,146761,433821,95172,300669,847363,144803,1277609,814.1
477,Uusimaa,1994,43.3,8.1,42.0,8.4,42.6,8.3,312.1,278.8,294.3,155910,418288,51204,149005,438275,96395,304915,856563,147599,1293573,785.9
478,Uusimaa,1995,43.8,8.2,42.1,8.7,42.9,8.5,317.4,285.7,300.5,157614,423582,52824,150781,443613,97547,308395,867195,150371,1310680,807.9
479,Uusimaa,1996,44.7,8.0,42.6,8.3,43.6,8.2,322.7,292.7,306.7,159311,428886,54316,152410,448896,98462,311721,877782,152778,1327243,859.7
480,Uusimaa,1997,46.8,7.8,44.0,8.2,45.4,8.0,327.7,300.3,313.1,160739,435071,55748,154366,454968,99345,315105,890039,155093,1344989,868.1
481,Uusimaa,1998,49.3,6.9,46.4,7.1,47.8,7.0,332.3,307.8,319.3,162003,441889,56991,155548,461257,99965,317551,903146,156956,1362634,877.7
482,Uusimaa,1999,50.3,6.6,47.4,6.8,48.8,6.7,336.8,315.2,325.4,163093,448159,58337,157119,467442,100902,320212,915601,159239,1379712,914.0
483,Uusimaa,2000,51.4,6.6,48.6,6.7,50.0,6.6,340.6,322.6,331.1,164049,453767,59819,157969,473041,101928,322018,926808,161747,1394199,947.9
484,Uusimaa,2001,51.1,6.5,48.9,6.4,50.0,6.5,344.0,329.8,336.5,164262,459250,61406,158400,478598,102921,322662,937848,164327,1408525,1033.0
485,Uusimaa,2002,50.4,6.8,48.6,6.7,49.5,6.7,347.3,335.0,340.8,164810,462867,63111,158718,482298,104281,323528,945165,167392,1419938,1120.8
486,Uusimaa,2003,49.8,7.0,48.3,6.8,49.0,6.9,350.5,341.8,345.9,165179,465451,65339,159245,484566,105880,324424,950017,171219,1429869,1137.4
487,Uusimaa,2004,49.9,7.1,48.2,6.9,49.0,7.0,353.8,348.4,351.0,165745,467510,67670,159876,485770,108339,325621,953280,176009,1439400,1180.9
488,Uusimaa,2005,49.6,7.6,48.0,7.5,48.8,7.5,356.5,354.3,355.4,166352,471559,69692,160862,489378,110068,327214,960937,179760,1452083,1253.6
489,Uusimaa,2006,50.2,7.7,48.5,7.5,49.3,7.6,360.0,361.2,360.7,167537,474841,73496,161898,492601,114050,329435,967442,187546,1467453,1293.1
490,Uusimaa,2007,51.1,7.5,49.5,7.3,50.3,7.4,362.8,367.5,365.2,168231,481347,75270,162238,498285,115664,330469,979632,190934,1483719,1362.4
491,Uusimaa,2008,51.0,7.4,50.0,7.0,50.5,7.2,367.0,376.6,372.0,169199,487205,78449,163060,503105,118712,332259,990310,197161,1501511,1468.4
492,Uusimaa,2009,48.4,7.7,48.6,7.2,48.5,7.5,370.1,382.1,376.4,169725,491343,81872,163785,507105,122259,333510,998448,204131,1517712,1503.2
493,Uusimaa,2010,48.8,7.7,48.4,7.4,48.6,7.5,374.4,388.0,381.5,170486,493786,86698,164068,508742,127479,334554,1002528,214177,1532309,1475.9
494,Uusimaa,2011,49.1,7.5,48.5,7.2,48.8,7.4,377.2,393.6,385.7,170824,496478,92307,164193,510329,133666,335017,1006807,225973,1549058,1535.1
495,Uusimaa,2012,48.6,7.5,48.1,7.2,48.3,7.3,379.9,399.0,389.9,171397,500065,97658,164547,512298,139658,335944,1012363,237316,1566835,1582.6
496,Uusimaa,2013,47.5,7.5,47.1,7.2,47.3,7.4,384.7,405.8,395.7,172190,503520,102848,165186,514502,145578,337376,1018022,248426,1585473,1635.8
497,Uusimaa,2014,46.8,7.6,46.2,7.3,46.5,7.5,387.2,410.7,399.5,173099,506891,107495,166167,516635,150785,339266,1023526,258280,1603389,1639.0
498,Uusimaa,2015,46.4,7.6,45.7,7.4,46.0,7.5,388.1,414.4,401.8,174341,510365,111500,167229,518801,155496,341570,1029166,266996,1620261,1641.3
499,Uusimaa,2016,46.7,7.5,45.7,7.3,46.2,7.4,391.0,419.8,406.0,176139,515194,114945,167942,521485,159579,344081,1036679,274524,1638293,1532.1
500,Uusimaa,2017,47.6,7.3,46.2,7.1,46.9,7.2,395.9,426.6,411.9,177526,519853,118637,169180,523865,164148,346706,1043718,282785,1655624,1623.5
501,Uusimaa,2018,48.5,7.1,47.0,7.0,47.7,7.1,407.0,438.4,423.3,177892,524299,121930,169823,526400,168216,347715,1050699,290146,1671024,1621.3
502,Uusimaa,2019,48.7,7.3,47.0,7.3,47.8,7.3,409.5,443.5,427.1,178327,530600,125213,170390,530100,172629,348717,1060700,297842,1689725,1741.8
503,Uusimaa,2020,46.0,7.7,44.3,8.0,45.1,7.8,412.2,449.0,431.2,178719,534107,128223,170864,532135,176135,349583,1066242,304358,1702678,1807.3
504,Åland,1993,49.2,5.5,43.2,5.9,46.1,5.7,241.1,199.1,219.4,3016,7876,1632,2788,7625,2467,5804,15501,4099,25102,455.2
505,Åland,1994,48.1,5.8,42.7,5.9,45.3,5.8,244.9,204.3,224.0,2990,7871,1655,2825,7629,2489,5815,15500,4144,25158,127.0
506,Åland,1995,48.0,6.8,43.3,6.2,45.6,6.5,248.2,211.0,229.0,3008,7851,1653,2837,7657,2453,5845,15508,4106,25202,122.9
507,Åland,1996,48.6,6.8,43.8,6.0,46.1,6.4,250.4,217.2,233.3,3052,7837,1656,2848,7697,2449,5900,15534,4105,25257,139.7
508,Åland,1997,50.0,6.2,44.9,5.4,47.4,5.8,253.4,220.5,236.4,3051,7838,1694,2889,7724,2464,5940,15562,4158,25392,0.0
509,Åland,1998,51.7,4.2,46.7,4.1,49.2,4.1,255.7,225.7,240.2,3075,7973,1710,2910,7823,2467,5985,15796,4177,25625,0.0
510,Åland,1999,51.2,5.5,47.9,4.8,49.5,5.2,259.2,231.2,244.8,3062,8017,1720,2906,7829,2457,5968,15846,4177,25706,3.0
511,Åland,2000,51.8,5.5,48.6,4.7,50.2,5.1,260.4,234.9,247.3,3069,8037,1757,2902,7853,2467,5971,15890,4224,25776,-2.0
512,Åland,2001,51.9,5.6,49.0,4.6,50.5,5.1,265.3,242.0,253.3,3054,8100,1783,2921,7942,2497,5975,16042,4280,26008,0.1
513,Åland,2002,51.9,5.5,49.2,4.7,50.5,5.1,266.9,245.2,255.7,3085,8164,1824,2917,8037,2512,6002,16201,4336,26257,-0.8
514,Åland,2003,50.9,5.8,48.6,5.5,49.7,5.6,267.4,246.0,256.3,3076,8181,1857,2929,8097,2504,6005,16278,4361,26347,-2.6
515,Åland,2004,50.2,6.1,48.6,5.4,49.4,5.7,267.0,250.5,258.5,3114,8270,1884,2931,8115,2527,6045,16385,4411,26530,-2.3
516,Åland,2005,50.2,6.3,48.8,5.9,49.4,6.1,267.8,255.7,261.6,3106,8356,1946,2920,8201,2548,6026,16557,4494,26766,-1.2
517,Åland,2006,50.3,6.2,49.3,5.6,49.8,5.9,270.9,261.6,266.1,3131,8377,2017,2923,8289,2546,6054,16666,4563,26923,4.3
518,Åland,2007,50.6,6.1,49.3,5.8,50.0,6.0,272.6,265.6,269.0,3120,8456,2079,2902,8348,2598,6022,16804,4677,27153,5.6
519,Åland,2008,50.7,5.8,51.0,5.2,50.8,5.5,273.7,270.3,272.0,3129,8538,2169,2920,8453,2610,6049,16991,4779,27456,6.4
520,Åland,2009,48.8,5.8,49.9,5.5,49.4,5.6,274.0,275.1,274.6,3123,8610,2252,2903,8514,2681,6026,17124,4933,27734,7.9
521,Åland,2010,48.1,6.3,49.6,5.6,48.9,6.0,273.4,278.9,276.2,3107,8675,2358,2889,8549,2787,5996,17224,5145,28007,12.8
522,Åland,2011,48.8,5.8,49.9,5.3,49.4,5.6,273.8,283.4,278.6,3099,8742,2472,2925,8586,2885,6024,17328,5357,28354,13.5
523,Åland,2012,48.1,5.6,49.7,5.2,48.9,5.4,276.4,288.1,282.3,3090,8695,2579,2931,8584,2947,6021,17279,5526,28501,13.1
524,Åland,2013,47.7,5.9,49.5,5.0,48.6,5.5,282.0,295.6,288.9,3127,8685,2680,2920,8607,3025,6047,17292,5705,28666,14.6
525,Åland,2014,50.2,5.6,50.0,4.7,50.1,5.1,283.3,298.5,291.0,3134,8713,2776,2910,8596,3123,6044,17309,5899,28916,16.6
526,Åland,2015,49.9,5.7,49.9,4.4,49.9,5.0,280.9,298.2,289.6,3104,8709,2828,2900,8568,3195,6004,17277,6023,28983,26.6
527,Åland,2016,50.0,5.5,50.0,4.3,50.0,4.9,281.6,301.9,291.8,3147,8716,2892,2939,8594,3277,6086,17310,6169,29214,20.2
528,Åland,2017,50.1,5.0,49.9,4.1,50.0,4.6,318.8,344.4,331.8,3156,8758,2984,2947,8562,3417,6103,17320,6401,29489,15.9
529,Åland,2018,49.8,4.9,50.1,4.1,49.9,4.5,322.8,351.4,337.3,3212,8727,3105,2995,8540,3515,6207,17267,6620,29789,13.8
530,Åland,2019,48.7,5.6,48.6,4.8,48.7,5.2,325.0,356.8,341.2,3201,8662,3181,3022,8526,3605,6223,17188,6786,29884,16.4
531,Åland,2020,45.2,6.1,45.7,5.2,45.4,5.6,324.3,358.4,341.6,3201,8700,3240,3058,8543,3691,6259,17243,6931,30129,24.2
