,region,year,alcohol_sales,male_length_education,female_length_education,combined_length_education,male_0_18,male_18_64,male_65,female_0_18,female_18_64,female_65,combined_0_18,combined_18_64,combined_65,pop_total,health_cost
0,Central Finland,1993,6.5,236.0,226.9,231.3,33139,82320,13731,31514,78184,23034,64653,160504,36765,258485,2753.7
1,Central Finland,1994,6.3,240.0,233.0,236.4,32988,82406,14113,31524,78412,23429,64512,160818,37542,259392,2656.4
2,Central Finland,1995,6.5,244.8,239.1,241.9,32715,82518,14473,31322,78565,23728,64037,161083,38201,259778,2833.8
3,Central Finland,1996,6.7,249.4,245.4,247.4,32563,82863,14887,31092,78943,24042,63655,161806,38929,260835,2943.6
4,Central Finland,1997,6.7,254.3,251.8,253.0,32311,83018,15197,30859,79184,24347,63170,162202,39544,261559,2690.9
5,Central Finland,1998,6.8,259.2,258.5,258.8,31968,83088,15433,30668,79575,24481,62636,162663,39914,261754,2746.2
6,Central Finland,1999,6.8,263.9,264.6,264.3,31739,83255,15655,30350,79757,24722,62089,163012,40377,262106,2813.1
7,Central Finland,2000,6.8,268.5,271.1,269.9,31508,83663,16019,30066,80164,24896,61574,163827,40915,262710,2933.7
8,Central Finland,2001,7.1,273.7,277.5,275.6,31096,84156,16252,29847,80690,25094,60943,164846,41346,263574,3149.7
9,Central Finland,2002,7.4,278.5,282.8,280.7,30706,84355,16644,29539,80892,25335,60245,165247,41979,263889,3349.3
10,Central Finland,2003,7.4,284.0,290.0,287.1,30426,84650,17098,29356,81237,25582,59782,165887,42680,264936,3519.7
11,Central Finland,2004,7.9,289.1,297.0,293.2,30283,84806,17583,29176,81450,26105,59459,166256,43688,266047,3660.7
12,Central Finland,2005,8.0,293.1,302.6,298.0,30082,84970,18014,29036,81469,26384,59118,166439,44398,266770,3767.8
13,Central Finland,2006,8.2,297.1,308.8,303.1,30104,84602,18906,29034,81294,27025,59138,165896,45931,267481,3864.6
14,Central Finland,2007,8.5,302.7,316.1,309.6,29981,84935,18991,28865,81500,27034,58846,166435,46025,267998,4021.9
15,Central Finland,2008,8.4,307.7,324.2,316.1,29865,85172,19431,28870,81861,27345,58735,167033,46776,269108,4449.2
16,Central Finland,2009,8.3,311.6,330.3,321.2,29865,85347,19848,28799,82063,27658,58664,167410,47506,270195,4567.7
17,Central Finland,2010,8.1,316.0,336.4,326.4,29789,85272,20617,28709,81888,28300,58498,167160,48917,271083,4668.6
18,Central Finland,2011,8.1,320.4,343.2,332.0,29700,84912,21496,28545,81472,29106,58245,166384,50602,271874,4920.3
19,Central Finland,2012,7.7,324.5,349.5,337.2,29577,84503,22549,28480,81052,29953,58057,165555,52502,272723,5187.7
20,Central Finland,2013,7.5,329.6,356.1,343.1,29338,83726,23715,28243,80211,30905,57581,163937,54620,272911,5357.3
21,Central Finland,2014,7.3,334.0,362.1,348.3,29211,83086,24626,28112,79498,31698,57323,162584,56324,272990,5350.3
22,Central Finland,2015,7.1,336.5,366.7,351.8,29001,82655,25516,27941,78945,32488,56942,161600,58004,273446,5406.5
23,Central Finland,2016,7.1,340.3,372.3,356.5,28865,82600,26210,27737,78471,33005,56602,161071,59215,273910,5508.9
24,Central Finland,2017,7.1,345.3,379.4,362.6,28706,81959,27026,27448,77949,33648,56154,159908,60674,273779,5486.5
25,Central Finland,2018,7.1,350.7,387.3,369.3,28443,81478,27580,27155,77342,34266,55598,158820,61846,273283,5599.3
26,Central Finland,2019,6.9,354.0,392.5,373.5,27988,81023,28296,26825,76756,34905,54813,157779,63201,272898,5895.6
27,Central Finland,2020,6.9,357.9,398.5,378.4,27732,80506,28957,26546,76246,35548,54278,156752,64505,272617,6006.9
28,Central Ostrobothnia,1993,4.7,202.0,208.2,205.2,10126,21269,3456,9762,20242,5593,19888,41511,9049,69315,2544.1
29,Central Ostrobothnia,1994,4.7,206.7,214.0,210.4,10038,21368,3535,9696,20366,5725,19734,41734,9260,69627,2585.1
30,Central Ostrobothnia,1995,4.9,210.4,220.3,215.4,9928,21342,3656,9622,20348,5801,19550,41690,9457,69539,2810.9
31,Central Ostrobothnia,1996,5.1,214.3,225.3,219.9,9752,21279,3755,9426,20229,5867,19178,41508,9622,69213,2967.4
32,Central Ostrobothnia,1997,5.2,218.8,230.8,225.0,9578,21249,3857,9337,20152,5912,18915,41401,9769,69021,2628.2
33,Central Ostrobothnia,1998,5.3,223.2,235.5,229.5,9444,21229,3924,9236,20068,5962,18680,41297,9886,68773,2660.6
34,Central Ostrobothnia,1999,5.4,226.4,240.7,233.7,9248,21109,4024,9084,19959,6021,18332,41068,10045,68345,2743.4
35,Central Ostrobothnia,2000,5.4,229.3,245.8,237.7,9101,21019,4117,8946,19913,6098,18047,40932,10215,68052,2895.7
36,Central Ostrobothnia,2001,5.7,233.1,251.3,242.4,8910,20948,4172,8751,19809,6177,17661,40757,10349,67671,3132.4
37,Central Ostrobothnia,2002,6.0,239.0,256.1,247.7,8759,20913,4266,8626,19842,6196,17385,40755,10462,67497,3317.0
38,Central Ostrobothnia,2003,6.2,243.9,262.3,253.3,8642,20855,4384,8522,19858,6237,17164,40713,10621,67441,3514.0
39,Central Ostrobothnia,2004,6.7,248.4,269.0,258.9,8569,20810,4508,8334,19829,6336,16903,40639,10844,67369,3732.0
40,Central Ostrobothnia,2005,6.8,252.5,275.7,264.3,8536,20880,4592,8316,19856,6409,16852,40736,11001,67612,3868.2
41,Central Ostrobothnia,2006,7.0,256.9,281.9,269.6,8407,20747,4791,8301,19744,6605,16708,40491,11396,67632,4014.9
42,Central Ostrobothnia,2007,7.1,261.5,287.8,274.9,8398,20833,4815,8305,19872,6651,16703,40705,11466,67898,4235.2
43,Central Ostrobothnia,2008,7.1,265.2,294.8,280.2,8378,20878,4909,8223,19902,6709,16601,40780,11618,67991,4569.3
44,Central Ostrobothnia,2009,7.0,269.6,301.0,285.6,8361,20756,5001,8210,19891,6837,16571,40647,11838,68131,4727.6
45,Central Ostrobothnia,2010,6.9,274.6,307.1,291.2,8399,20638,5213,8177,19856,6988,16576,40494,12201,68321,4967.3
46,Central Ostrobothnia,2011,7.2,278.3,313.4,296.2,8394,20514,5489,8175,19710,7174,16569,40224,12663,68484,5280.4
47,Central Ostrobothnia,2012,6.8,282.4,319.4,301.2,8356,20339,5747,8151,19506,7446,16507,39845,13193,68610,5506.8
48,Central Ostrobothnia,2013,6.8,287.7,325.6,306.9,8361,20109,6025,8150,19368,7648,16511,39477,13673,68677,5598.8
49,Central Ostrobothnia,2014,6.7,291.7,332.5,312.4,8367,19952,6278,8116,19156,7868,16483,39108,14146,68830,5617.4
50,Central Ostrobothnia,2015,6.5,293.9,338.3,316.4,8375,19839,6503,8135,19018,8037,16510,38857,14540,69032,5669.6
51,Central Ostrobothnia,2016,6.4,296.8,343.2,320.3,8391,19660,6719,8105,18805,8208,16496,38465,14927,69027,5854.8
52,Central Ostrobothnia,2017,6.4,301.5,349.3,325.7,8344,19372,6910,8049,18555,8378,16393,37927,15288,68780,5869.1
53,Central Ostrobothnia,2018,6.2,306.4,356.6,331.8,8304,19110,7081,8002,18248,8535,16306,37358,15616,68437,6029.3
54,Central Ostrobothnia,2019,6.1,310.4,362.1,336.6,8204,18853,7258,7981,18049,8658,16185,36902,15916,68158,6241.0
55,Central Ostrobothnia,2020,6.2,314.6,367.9,341.5,8164,18781,7391,7883,17840,8803,16047,36621,16194,67988,6456.1
56,Kainuu,1993,6.1,214.5,214.2,214.3,12004,29832,4817,11763,27269,7369,23767,57101,12186,91794,2935.4
57,Kainuu,1994,6.0,218.0,219.2,218.6,11869,29517,5040,11665,27063,7571,23534,56580,12611,91350,2997.4
58,Kainuu,1995,6.2,221.2,224.4,222.8,11707,29166,5280,11420,26801,7752,23127,55967,13032,90781,3156.0
59,Kainuu,1996,6.1,225.2,229.3,227.2,11490,28837,5435,11197,26430,7935,22687,55267,13370,90035,3219.6
60,Kainuu,1997,6.3,227.8,233.1,230.5,11111,28480,5526,10988,26046,8104,22099,54526,13630,88896,3044.8
61,Kainuu,1998,6.4,230.9,237.8,234.4,10817,28157,5607,10636,25748,8216,21453,53905,13823,87843,3139.2
62,Kainuu,1999,6.5,234.3,242.1,238.2,10517,27840,5745,10348,25459,8277,20865,53299,14022,86943,3189.9
63,Kainuu,2000,6.4,236.7,245.9,241.3,10208,27427,5868,10087,25032,8447,20295,52459,14315,85736,3347.5
64,Kainuu,2001,6.8,239.5,250.5,245.0,9795,27106,5994,9708,24702,8570,19503,51808,14564,84497,3571.6
65,Kainuu,2002,7.0,242.8,254.0,248.4,9472,26818,6068,9318,24390,8661,18790,51208,14729,83477,3756.2
66,Kainuu,2003,7.2,246.8,258.9,252.9,9234,26506,6222,9072,24190,8741,18306,50696,14963,82744,3983.2
67,Kainuu,2004,7.9,250.8,264.6,257.7,9014,26293,6382,8825,23930,8924,17839,50223,15306,82214,3937.2
68,Kainuu,2005,8.3,255.0,269.4,262.2,8831,26058,6451,8582,23749,9022,17413,49807,15473,81585,3880.2
69,Kainuu,2006,8.5,260.3,276.2,268.3,8651,25617,6674,8318,23358,9220,16969,48975,15894,80738,4159.0
70,Kainuu,2007,8.8,264.1,282.0,273.1,8453,25473,6705,8133,23228,9239,16586,48701,15944,80218,4363.9
71,Kainuu,2008,9.0,269.0,289.2,279.2,8296,25297,6814,8025,23102,9251,16321,48399,16065,79690,4701.4
72,Kainuu,2009,8.9,273.5,295.2,284.4,8119,25071,6881,7899,22955,9315,16018,48026,16196,79234,4952.2
73,Kainuu,2010,8.7,277.4,300.5,289.0,7995,24797,7072,7758,22666,9473,15753,47463,16545,78703,5160.3
74,Kainuu,2011,8.9,281.5,305.9,293.7,7812,24456,7293,7546,22281,9611,15358,46737,16904,77984,5666.0
75,Kainuu,2012,8.6,285.4,310.7,298.1,7633,24103,7517,7410,21902,9857,15043,46005,17374,77435,5787.9
76,Kainuu,2013,8.5,290.3,316.0,303.2,7460,23662,7816,7251,21440,10113,14711,45102,17929,76782,6549.5
77,Kainuu,2014,8.3,293.9,322.0,308.0,7299,23190,8093,7115,21061,10288,14414,44251,18381,76119,6522.9
78,Kainuu,2015,8.0,295.5,327.2,311.4,7131,22673,8353,6845,20677,10438,13976,43350,18791,75324,6828.9
79,Kainuu,2016,8.1,299.2,332.9,316.1,7123,22265,8602,6739,20283,10593,13862,42548,19195,74803,6824.3
80,Kainuu,2017,8.0,304.1,339.5,321.8,6954,21749,8874,6648,19727,10784,13602,41476,19658,73959,6963.0
81,Kainuu,2018,8.1,309.0,347.2,328.1,6811,21231,9128,6471,19239,10950,13282,40470,20078,73061,7268.9
82,Kainuu,2019,7.9,311.9,351.5,331.6,6688,20708,9459,6329,18727,11142,13017,39435,20601,72306,7574.1
83,Kainuu,2020,8.0,314.8,357.6,336.1,6558,20416,9684,6177,18296,11260,12735,38712,20944,71664,7872.9
84,Kanta-Häme,1993,6.5,235.2,213.8,224.0,19652,51740,9513,18820,50149,16898,38472,101889,26411,164767,2608.2
85,Kanta-Häme,1994,6.3,239.5,219.4,229.0,19642,51635,9744,18913,49993,17117,38555,101628,26861,164957,2694.6
86,Kanta-Häme,1995,6.5,243.7,224.8,233.8,19554,51434,9940,18898,49770,17372,38452,101204,27312,164937,2818.7
87,Kanta-Häme,1996,6.6,247.2,230.3,238.4,19501,51288,10177,18793,49691,17462,38294,100979,27639,164892,2942.2
88,Kanta-Häme,1997,6.7,250.9,235.7,243.0,19460,51271,10316,18743,49666,17547,38203,100937,27863,165026,2605.1
89,Kanta-Häme,1998,6.8,254.6,241.4,247.7,19371,51235,10407,18599,49718,17496,37970,100953,27903,164914,2660.8
90,Kanta-Häme,1999,7.0,258.3,246.7,252.2,19412,51243,10619,18528,49878,17487,37940,101121,28106,165190,2668.8
91,Kanta-Häme,2000,7.0,261.7,252.4,256.8,19351,51204,10831,18505,49913,17540,37856,101117,28371,165307,2746.8
92,Kanta-Häme,2001,7.3,265.2,257.7,261.3,19265,51344,11039,18443,50037,17559,37708,101381,28598,165509,2889.2
93,Kanta-Häme,2002,7.8,268.8,262.8,265.7,18996,51491,11309,18290,50209,17664,37286,101700,28973,165886,3074.9
94,Kanta-Häme,2003,7.8,273.7,269.4,271.5,18963,51602,11600,18279,50403,17796,37242,102005,29396,166648,3263.8
95,Kanta-Häme,2004,8.3,278.0,275.8,276.8,18981,51727,11875,18411,50584,18047,37392,102311,29922,167630,3444.0
96,Kanta-Häme,2005,8.2,282.1,282.6,282.4,19008,52004,11983,18387,50894,18068,37395,102898,30051,168381,3624.9
97,Kanta-Häme,2006,8.5,286.1,289.2,287.7,19189,52340,12450,18445,51046,18533,37634,103386,30983,169952,3776.8
98,Kanta-Häme,2007,9.0,289.8,296.5,293.2,19277,52868,12561,18563,51738,18466,37840,104606,31027,171449,3944.8
99,Kanta-Häme,2008,8.8,293.4,303.3,298.5,19392,53328,12877,18711,52135,18749,38103,105463,31626,173041,4313.8
100,Kanta-Häme,2009,8.5,297.6,309.7,303.9,19384,53439,13202,18635,52450,18937,38019,105889,32139,173828,4428.3
101,Kanta-Häme,2010,8.4,301.0,315.4,308.5,19281,53480,13762,18501,52411,19349,37782,105891,33111,174555,4552.0
102,Kanta-Häme,2011,8.5,304.4,320.4,312.7,19148,53128,14518,18418,52067,20057,37566,105195,34575,175230,4804.3
103,Kanta-Häme,2012,7.9,306.9,326.0,316.8,19101,52760,15242,18281,51597,20666,37382,104357,35908,175472,5005.5
104,Kanta-Häme,2013,7.8,310.8,332.5,322.0,18979,52370,15869,18106,51106,21226,37085,103476,37095,175481,5105.8
105,Kanta-Häme,2014,7.5,313.7,337.3,325.8,18829,51976,16500,17883,50458,21800,36712,102434,38300,175349,5298.7
106,Kanta-Häme,2015,7.4,315.5,340.6,328.4,18555,51463,17050,17622,49791,22319,36177,101254,39369,174710,5330.7
107,Kanta-Häme,2016,7.3,318.2,345.3,332.1,18282,50836,17530,17293,48975,22803,35575,99811,40333,173781,5433.9
108,Kanta-Häme,2017,7.2,321.3,351.3,336.7,18043,50189,18102,16991,48194,23208,35034,98383,41310,172720,5435.2
109,Kanta-Häme,2018,7.3,325.5,358.3,342.3,17693,49431,18589,16595,47339,23649,34288,96770,42238,171364,5650.1
110,Kanta-Häme,2019,7.1,328.9,363.5,346.6,17351,49012,19061,16339,46877,24132,33690,95889,43193,170925,5655.6
111,Kanta-Häme,2020,7.4,332.0,368.2,350.5,17179,48706,19472,16012,46514,24592,33191,95220,44064,170577,5951.5
112,Kymenlaakso,1993,7.3,237.4,209.9,223.2,21234,60327,10635,20312,57059,18866,41546,117386,29501,186054,2632.8
113,Kymenlaakso,1994,7.0,241.1,215.0,227.6,21084,59965,10970,20184,56706,19043,41268,116671,30013,185462,2676.2
114,Kymenlaakso,1995,6.6,244.6,220.2,232.0,20782,59522,11251,19952,56223,19223,40734,115745,30474,184595,2772.1
115,Kymenlaakso,1996,6.9,248.2,225.4,236.4,20584,59000,11498,19751,55846,19372,40335,114846,30870,183819,2934.8
116,Kymenlaakso,1997,7.1,251.2,230.4,240.4,20305,58591,11718,19605,55488,19503,39910,114079,31221,182942,2611.8
117,Kymenlaakso,1998,7.1,254.8,234.8,244.5,20071,58333,11833,19431,55221,19536,39502,113554,31369,182215,2646.6
118,Kymenlaakso,1999,7.1,257.2,239.2,247.9,19836,57846,12072,19175,54838,19530,39011,112684,31602,181122,2801.1
119,Kymenlaakso,2000,7.0,260.1,244.2,251.9,19592,57420,12246,18918,54488,19559,38510,111908,31805,179940,2848.5
120,Kymenlaakso,2001,7.5,262.7,248.8,255.5,19377,57186,12492,18661,54276,19602,38038,111462,32094,179292,3114.5
121,Kymenlaakso,2002,7.8,266.0,253.3,259.5,19069,57101,12679,18386,54024,19664,37455,111125,32343,178735,3295.3
122,Kymenlaakso,2003,8.0,269.3,258.7,263.9,18832,56969,12998,18130,53806,19784,36962,110775,32782,178341,3449.7
123,Kymenlaakso,2004,8.5,272.2,264.3,268.2,18629,56697,13369,17906,53535,20049,36535,110232,33418,178205,3714.6
124,Kymenlaakso,2005,8.5,275.3,270.0,272.6,18501,56481,13557,17823,53419,20175,36324,109900,33732,177931,3901.2
125,Kymenlaakso,2006,8.7,278.8,275.7,277.2,18200,55770,14043,17610,52828,20634,35810,108598,34677,176995,3949.0
126,Kymenlaakso,2007,9.2,281.3,281.4,281.4,18048,55601,14070,17379,52656,20669,35427,108257,34739,176356,4053.4
127,Kymenlaakso,2008,9.0,283.6,287.1,285.4,17790,55238,14423,17143,52373,20836,34933,107611,35259,175661,4431.3
128,Kymenlaakso,2009,8.8,287.3,292.6,290.1,17611,55014,14742,16922,52117,21103,34533,107131,35845,175403,4839.9
129,Kymenlaakso,2010,8.6,289.7,297.2,293.5,17469,54521,15404,16825,51644,21640,34294,106165,37044,175377,4911.7
130,Kymenlaakso,2011,8.6,291.9,301.8,297.0,17194,53894,16088,16608,50989,22203,33802,104883,38291,174827,5234.7
131,Kymenlaakso,2012,8.0,294.0,306.5,300.4,17026,53228,16771,16433,50282,22864,33459,103510,39635,174466,5619.4
132,Kymenlaakso,2013,8.0,297.4,312.6,305.2,16722,52522,17419,16180,49588,23518,32902,102110,40937,173864,5770.5
133,Kymenlaakso,2014,7.7,300.3,317.3,309.0,16418,51600,18140,15900,48819,24006,32318,100419,42146,172907,5872.6
134,Kymenlaakso,2015,7.5,300.8,320.7,311.0,16136,50788,18723,15581,47970,24445,31717,98758,43168,171778,5921.8
135,Kymenlaakso,2016,7.5,303.6,324.6,314.3,15874,50160,19103,15357,47277,24869,31231,97437,43972,170770,6037.3
136,Kymenlaakso,2017,7.5,306.8,330.3,318.8,15464,49125,19573,14914,46145,25304,30378,95270,44877,168691,6050.8
137,Kymenlaakso,2018,7.6,312.3,338.8,325.8,15053,48255,19965,14450,45113,25530,29503,93368,45495,166623,6344.4
138,Kymenlaakso,2019,7.5,315.1,343.9,329.8,14618,47330,20201,14107,44137,25815,28725,91467,46016,164456,6540.1
139,Kymenlaakso,2020,8.0,317.5,348.8,333.5,14218,46572,20594,13715,43343,26022,27933,89915,46616,162812,6790.0
140,Lapland,1993,7.6,223.7,228.2,226.0,27317,66278,9860,26534,61164,14606,53851,127442,24466,202895,3174.2
141,Lapland,1994,7.5,227.4,233.5,230.5,27091,65842,10239,26287,60723,15032,53378,126565,25271,202325,3260.1
142,Lapland,1995,7.9,231.0,239.0,235.0,26622,65441,10594,25834,60378,15386,52456,125819,25980,201411,3408.3
143,Lapland,1996,8.0,234.3,244.1,239.2,26304,65143,10901,25449,59901,15761,51753,125044,26662,200579,3449.6
144,Lapland,1997,8.2,237.3,248.3,242.8,25817,64615,11153,24925,59415,15973,50742,124030,27126,199051,3003.2
145,Lapland,1998,8.4,240.1,252.7,246.4,25110,63736,11369,24269,58774,16160,49379,122510,27529,196647,3051.6
146,Lapland,1999,8.4,243.1,257.1,250.1,24535,62939,11621,23700,57904,16461,48235,120843,28082,194352,3112.1
147,Lapland,2000,8.4,245.7,261.2,253.5,23915,61975,11994,22946,57159,16728,46861,119134,28722,191768,3257.1
148,Lapland,2001,8.9,248.9,265.1,257.0,23150,61264,12284,22170,56193,17045,45320,117457,29329,189288,3469.6
149,Lapland,2002,9.3,252.4,269.9,261.2,22411,60640,12683,21632,55877,17393,44043,116517,30076,187778,3653.8
150,Lapland,2003,9.5,256.4,275.1,265.8,21793,60357,13089,21048,55594,17736,42841,115951,30825,186917,3825.8
151,Lapland,2004,11.0,260.4,281.2,270.8,21333,60089,13503,20625,55362,18105,41958,115451,31608,186443,3960.9
152,Lapland,2005,11.2,264.2,286.8,275.5,20940,59841,13743,20208,55270,18273,41148,115111,32016,185800,4154.1
153,Lapland,2006,11.7,267.9,292.8,280.3,20583,59141,14245,19857,54778,18834,40440,113919,33079,184935,4333.1
154,Lapland,2007,12.3,271.1,298.5,284.9,20296,59019,14351,19508,54907,18889,39804,113926,33240,184390,4473.2
155,Lapland,2008,12.0,274.8,305.3,290.1,19994,58840,14680,19165,54865,19028,39159,113705,33708,183963,4733.7
156,Lapland,2009,11.2,279.1,310.7,295.0,19681,58883,14856,18818,54852,19207,38499,113735,34063,183748,4935.6
157,Lapland,2010,10.9,283.0,316.1,299.6,19406,58740,15197,18486,54698,19477,37892,113438,34674,183488,5148.0
158,Lapland,2011,11.2,286.8,322.4,304.6,19118,58196,15845,18296,54136,20127,37414,112332,35972,183330,5436.2
159,Lapland,2012,10.7,290.5,328.4,309.5,18900,57510,16536,18025,53591,20654,36925,111101,37190,182844,5824.0
160,Lapland,2013,10.6,295.1,335.3,315.3,18673,56702,17258,17834,52944,21232,36507,109646,38490,182514,6032.3
161,Lapland,2014,10.3,299.3,341.6,320.5,18485,55772,18025,17611,52207,21760,36096,107979,39785,181746,6217.3
162,Lapland,2015,10.1,301.8,346.3,324.1,18179,54817,18747,17366,51532,22215,35545,106349,40962,180858,6382.7
163,Lapland,2016,10.1,305.3,352.0,328.7,18071,54027,19266,17115,51074,22625,35186,105101,41891,180207,6372.6
164,Lapland,2017,10.2,311.1,360.4,335.9,17814,53040,19882,16910,50458,23035,34724,103498,42917,179223,6367.7
165,Lapland,2018,10.2,316.7,368.4,342.7,17554,52250,20491,16756,49943,23465,34310,102193,43956,178522,6659.1
166,Lapland,2019,10.0,320.0,374.2,347.3,17271,51419,20913,16427,49003,23955,33698,100422,44868,177161,6944.3
167,Lapland,2020,9.4,323.2,380.4,351.9,17063,50879,21443,16256,48326,24466,33319,99205,45909,176665,7016.3
168,North Karelia,1993,6.2,215.5,212.4,213.9,23122,58570,10313,22020,54285,17389,45142,112855,27702,183293,2918.5
169,North Karelia,1994,6.0,220.0,218.5,219.2,22912,58360,10591,21882,53980,17657,44794,112340,28248,183038,2932.5
170,North Karelia,1995,5.9,224.1,224.0,224.0,22757,57992,10853,21653,53525,17953,44410,111517,28806,182336,3020.4
171,North Karelia,1996,5.9,227.8,229.4,228.6,22439,57504,11043,21294,53176,18044,43733,110680,29087,181160,3146.8
172,North Karelia,1997,6.1,231.4,234.8,233.1,22175,57012,11230,21013,52678,18157,43188,109690,29387,179977,2720.0
173,North Karelia,1998,6.1,234.8,239.8,237.4,21831,56593,11365,20625,52343,18101,42456,108936,29466,178441,2722.6
174,North Karelia,1999,6.1,238.9,245.7,242.3,21374,56225,11557,20297,51963,18180,41671,108188,29737,177238,2781.2
175,North Karelia,2000,6.1,242.5,250.6,246.6,20960,56072,11763,19927,51681,18230,40887,107753,29993,176187,2924.2
176,North Karelia,2001,6.3,246.6,257.0,251.9,20496,55969,11983,19541,51489,18401,40037,107458,30384,175322,3083.3
177,North Karelia,2002,6.6,250.1,262.4,256.3,20039,55709,12176,19062,51279,18387,39101,106988,30563,174236,3273.0
178,North Karelia,2003,6.7,255.2,268.4,261.9,19626,55396,12476,18615,51256,18523,38241,106652,30999,173580,3451.3
179,North Karelia,2004,7.3,259.9,274.2,267.1,19194,55177,12813,18287,51159,18691,37481,106336,31504,173018,3612.5
180,North Karelia,2005,7.6,264.8,280.6,272.8,18812,55254,12896,17957,51146,18752,36769,106400,31648,172629,3768.2
181,North Karelia,2006,7.8,269.1,287.2,278.3,18455,54740,13358,17664,50702,19104,36119,105442,32462,171758,4118.6
182,North Karelia,2007,8.0,273.2,293.5,283.5,18157,54641,13385,17319,50617,19069,35476,105258,32454,170896,4332.7
183,North Karelia,2008,8.0,278.6,301.2,290.0,17782,54374,13662,16994,50392,19222,34776,104766,32884,170194,4670.2
184,North Karelia,2009,7.9,282.6,306.5,294.7,17455,54338,13922,16712,50267,19452,34167,104605,33374,169937,4836.4
185,North Karelia,2010,7.8,287.0,313.0,300.2,17156,53959,14494,16470,50123,19827,33626,104082,34321,169778,5008.8
186,North Karelia,2011,7.8,290.8,319.4,305.3,16901,53423,15142,16325,49765,20226,33226,103188,35368,169733,5193.5
187,North Karelia,2012,7.4,295.1,325.3,310.4,16697,52813,15830,16172,49314,20689,32869,102127,36519,169496,5119.7
188,North Karelia,2013,7.4,300.1,332.0,316.2,16484,52219,16454,15997,48734,21220,32481,100953,37674,169112,5463.3
189,North Karelia,2014,7.2,304.6,337.8,321.3,16251,51551,17222,15836,48269,21625,32087,99820,38847,168896,5534.9
190,North Karelia,2015,7.0,307.9,343.1,325.6,16003,50842,17880,15662,47779,22065,31665,98621,39945,168329,5706.6
191,North Karelia,2016,7.0,311.7,348.6,330.3,15779,50209,18422,15416,47196,22371,31195,97405,40793,167599,5866.2
192,North Karelia,2017,6.9,315.7,354.8,335.4,15455,49291,19095,15123,46563,22747,30578,95854,41842,166441,5807.2
193,North Karelia,2018,6.6,321.9,363.0,342.6,15181,48527,19621,14721,46110,23115,29902,94637,42736,165569,5911.0
194,North Karelia,2019,6.7,325.9,368.7,347.5,14918,47776,20123,14413,45392,23536,29331,93168,43659,164465,6145.7
195,North Karelia,2020,7.1,329.3,373.9,351.8,14590,47091,20643,14292,44643,23950,28882,91734,44593,163537,6358.5
196,North Ostrobothnia,1993,5.7,241.8,234.4,238.0,54062,112171,15988,51618,105244,25733,105680,217415,41721,359433,2696.5
197,North Ostrobothnia,1994,5.6,247.4,240.3,243.8,54024,113147,16501,51543,105850,26284,105567,218997,42785,361751,2803.0
198,North Ostrobothnia,1995,5.8,252.8,247.1,249.9,53992,114027,17071,51608,106487,26756,105600,220514,43827,364443,2951.3
199,North Ostrobothnia,1996,5.9,258.0,253.9,255.9,53699,114756,17589,51403,107141,27205,105102,221897,44794,366218,3071.2
200,North Ostrobothnia,1997,6.0,263.2,260.9,262.0,53423,115337,18051,51017,107691,27463,104440,223028,45514,367361,2770.1
201,North Ostrobothnia,1998,6.0,268.2,267.5,267.9,53032,116009,18353,50576,108315,27647,103608,224324,46000,368302,2759.7
202,North Ostrobothnia,1999,6.0,273.5,274.3,273.9,52859,116936,18737,50146,108857,27952,103005,225793,46689,369827,2826.7
203,North Ostrobothnia,2000,6.2,278.9,281.7,280.4,52728,118262,19213,50034,109921,28344,102762,228183,47557,372639,2949.2
204,North Ostrobothnia,2001,6.4,283.5,288.5,286.0,52297,119555,19658,49733,111061,28699,102030,230616,48357,375182,3114.2
205,North Ostrobothnia,2002,6.6,288.1,294.3,291.2,52056,120464,20183,49337,111787,29015,101393,232251,49198,377045,3344.3
206,North Ostrobothnia,2003,6.7,292.5,301.5,297.0,51682,121075,20801,49029,112360,29446,100711,233435,50247,378903,3488.1
207,North Ostrobothnia,2004,7.3,297.6,308.3,303.0,51814,121604,21421,49081,113093,30091,100895,234697,51512,381792,3712.3
208,North Ostrobothnia,2005,7.4,302.0,314.7,308.4,52089,122424,21798,49366,114045,30447,101455,236469,52245,384808,3856.2
209,North Ostrobothnia,2006,7.5,306.8,321.5,314.2,52328,122311,22888,49615,114059,31402,101943,236370,54290,387320,4013.4
210,North Ostrobothnia,2007,7.7,310.9,328.2,319.5,52677,123320,23203,49842,114977,31614,102519,238297,54817,390038,4182.0
211,North Ostrobothnia,2008,7.7,316.4,336.6,326.5,52742,124018,23819,49915,115441,32168,102657,239459,55987,392652,4502.9
212,North Ostrobothnia,2009,7.6,320.7,342.4,331.6,52926,124792,24379,50258,116233,32552,103184,241025,56931,395510,4676.0
213,North Ostrobothnia,2010,7.4,325.1,348.4,336.8,53093,125025,25413,50400,116584,33480,103493,241609,58893,398335,4785.3
214,North Ostrobothnia,2011,7.5,328.8,353.4,341.1,53224,125014,26654,50473,116746,34693,103697,241760,61347,401201,5028.0
215,North Ostrobothnia,2012,7.2,332.8,359.3,346.1,53430,125047,27910,50562,116541,35882,103992,241588,63792,403920,5245.4
216,North Ostrobothnia,2013,7.0,337.7,365.8,351.7,53627,124926,29195,50622,116522,37131,104249,241448,66326,406480,5443.3
217,North Ostrobothnia,2014,6.9,342.1,371.8,357.0,53552,124519,30595,50552,116106,38369,104104,240625,68964,408537,5487.3
218,North Ostrobothnia,2015,6.6,344.9,376.4,360.6,53377,124243,31973,50473,115637,39553,103850,239880,71526,410054,5524.0
219,North Ostrobothnia,2016,6.6,348.6,381.6,365.1,53126,123786,33263,50339,115077,40626,103465,238863,73889,411150,5696.1
220,North Ostrobothnia,2017,6.5,353.1,387.8,370.3,52902,123401,34541,50039,114312,41921,102941,237713,76462,411856,5660.9
221,North Ostrobothnia,2018,6.6,359.0,395.5,377.2,52133,123091,35706,49652,113755,42979,101785,236846,78685,412161,5853.8
222,North Ostrobothnia,2019,6.4,362.5,400.4,381.3,51350,122805,36903,49253,113421,44162,100603,236226,81065,412830,6145.3
223,North Ostrobothnia,2020,6.4,366.3,405.6,385.9,51028,122557,38043,48883,113263,45351,99911,235820,83394,413830,6297.0
224,North Savo,1993,6.6,224.3,224.2,224.3,33379,84809,14525,32277,80363,25067,65656,165172,39592,266956,2784.9
225,North Savo,1994,6.5,228.3,230.0,229.2,33219,84608,14997,32148,80192,25391,65367,164800,40388,266870,2851.2
226,North Savo,1995,6.8,232.6,236.2,234.4,32845,84259,15405,31784,79867,25742,64629,164126,41147,266308,2932.6
227,North Savo,1996,6.9,236.9,242.4,239.7,32481,83920,15791,31356,79519,25977,63837,163439,41768,265644,3076.3
228,North Savo,1997,7.1,240.8,247.9,244.5,32149,83412,16128,31030,79188,26209,63179,162600,42337,264578,2737.5
229,North Savo,1998,7.0,244.6,253.0,248.9,31656,82933,16326,30519,78729,26265,62175,161662,42591,262946,2803.0
230,North Savo,1999,7.0,248.2,258.4,253.5,31135,82491,16653,30044,78256,26411,61179,160747,43064,261393,2832.7
231,North Savo,2000,6.9,251.8,263.7,257.9,30539,81940,16932,29547,77568,26613,60086,159508,43545,259639,2973.7
232,North Savo,2001,7.3,255.9,269.4,262.9,30121,81690,17181,29158,77437,26779,59279,159127,43960,258664,3142.1
233,North Savo,2002,7.5,260.5,274.4,267.6,29466,81670,17442,28514,77318,26973,57980,158988,44415,257728,3356.1
234,North Savo,2003,7.6,265.0,280.6,273.0,28918,81456,17887,27920,77046,27259,56838,158502,45146,257079,3495.2
235,North Savo,2004,8.1,269.1,286.6,278.1,28611,81139,18379,27496,76836,27583,56107,157975,45962,256740,3698.5
236,North Savo,2005,8.3,273.1,292.6,283.1,28145,80782,18586,27123,76485,27709,55268,157267,46295,255683,3856.5
237,North Savo,2006,8.6,277.5,299.2,288.6,27856,80418,19257,26815,75941,28235,54671,156359,47492,255094,4004.8
238,North Savo,2007,8.9,281.9,305.4,293.9,27336,80319,19356,26427,76064,28112,53763,156383,47468,254367,4215.5
239,North Savo,2008,8.8,286.6,312.9,300.1,27113,80050,19699,26039,75987,28302,53152,156037,48001,253899,4503.4
240,North Savo,2009,8.6,290.7,318.8,305.1,26830,79992,20022,25622,75920,28552,52452,155912,48574,253605,4688.8
241,North Savo,2010,8.5,295.2,324.4,310.1,26464,79436,20755,25306,75617,29009,51770,155053,49764,253337,4860.4
242,North Savo,2011,8.6,299.0,330.4,315.0,26239,78870,21692,25015,75008,29756,51254,153878,51448,253472,5052.6
243,North Savo,2012,8.2,303.3,336.0,320.0,25986,78338,22544,24870,74582,30378,50856,152920,52922,253524,5369.3
244,North Savo,2013,8.1,308.8,343.2,326.3,25692,77599,23506,24584,74176,31103,50276,151775,54609,253643,5532.7
245,North Savo,2014,7.8,313.4,349.2,331.6,25436,77047,24404,24315,73490,31789,49751,150537,56193,253584,5645.8
246,North Savo,2015,7.6,316.0,354.5,335.6,25243,76321,25271,24141,72882,32268,49384,149203,57539,253239,5828.6
247,North Savo,2016,7.6,320.2,360.5,340.7,25012,75520,26009,23917,72269,32827,48929,147789,58836,252815,5943.6
248,North Savo,2017,7.4,324.6,367.2,346.3,24689,74416,26843,23596,71292,33488,48285,145708,60331,251570,5929.2
249,North Savo,2018,7.2,330.1,375.0,352.9,24382,73435,27561,23276,70386,34094,47658,143821,61655,250414,6149.6
250,North Savo,2019,7.4,333.6,380.5,357.4,23866,72441,28326,22935,69543,34663,46801,141984,62989,249003,6456.7
251,North Savo,2020,7.5,337.0,385.8,361.9,23492,71573,29063,22515,68892,35288,46007,140465,64351,248265,6626.9
252,Ostrobothnia,1993,4.0,231.9,217.4,224.4,21938,51321,10732,20552,49486,16941,42490,100807,27673,168698,2784.2
253,Ostrobothnia,1994,3.9,237.6,223.9,230.5,21869,51439,10855,20524,49321,17126,42393,100760,27981,168833,2836.3
254,Ostrobothnia,1995,4.1,243.3,230.7,236.8,21780,51487,10957,20455,49313,17172,42235,100800,28129,168888,2929.7
255,Ostrobothnia,1996,4.3,248.3,237.9,242.9,21715,51587,11152,20348,49415,17154,42063,101002,28306,169019,3075.9
256,Ostrobothnia,1997,4.3,252.9,243.9,248.3,21471,51832,11273,20112,49396,17209,41583,101228,28482,168964,2925.7
257,Ostrobothnia,1998,4.4,257.5,249.9,253.6,21291,51956,11439,19881,49392,17244,41172,101348,28683,168867,3031.8
258,Ostrobothnia,1999,4.5,261.0,255.6,258.2,21074,51870,11535,19613,49310,17218,40687,101180,28753,168326,3092.2
259,Ostrobothnia,2000,4.7,264.6,261.8,263.2,20829,51812,11713,19411,49351,17258,40240,101163,28971,168077,3218.0
260,Ostrobothnia,2001,4.9,268.8,267.4,268.1,20573,52062,11838,19208,49335,17280,39781,101397,29118,167986,3472.3
261,Ostrobothnia,2002,5.1,273.5,272.2,272.8,20380,52061,12000,19035,49209,17385,39415,101270,29385,167921,3678.0
262,Ostrobothnia,2003,5.2,277.4,279.0,278.2,20314,52090,12200,18933,49136,17546,39247,101226,29746,168046,3786.4
263,Ostrobothnia,2004,5.6,281.8,286.2,284.0,20179,52155,12462,18837,49200,17656,39016,101355,30118,168361,3958.7
264,Ostrobothnia,2005,5.8,285.2,292.4,288.9,20125,52343,12574,18749,49312,17583,38874,101655,30157,168583,4124.2
265,Ostrobothnia,2006,5.9,289.5,299.8,294.7,20087,52382,13007,18780,49129,17956,38867,101511,30963,169170,4188.6
266,Ostrobothnia,2007,6.2,293.6,307.6,300.7,20041,52737,13188,18829,49503,17941,38870,102240,31129,169971,4446.8
267,Ostrobothnia,2008,6.1,298.3,316.2,307.3,20104,53210,13450,18758,49746,18071,38862,102956,31521,170994,4803.1
268,Ostrobothnia,2009,6.1,302.5,322.8,312.8,20093,53586,13744,18723,49943,18259,38816,103529,32003,172085,5066.1
269,Ostrobothnia,2010,5.9,306.7,329.6,318.2,20049,53585,14318,18784,49843,18663,38833,103428,32981,172981,5133.5
270,Ostrobothnia,2011,6.0,310.2,336.1,323.2,20050,53510,15013,18889,49821,19171,38939,103331,34184,174170,5439.8
271,Ostrobothnia,2012,5.7,313.7,342.4,328.1,19915,53390,15553,18817,49777,19573,38732,103167,35126,174777,5723.4
272,Ostrobothnia,2013,5.7,319.3,350.3,334.8,19871,53386,16093,18783,49651,19940,38654,103037,36033,175530,5842.2
273,Ostrobothnia,2014,5.6,323.5,356.4,340.0,19875,53199,16654,18793,49559,20378,38668,102758,37032,176316,5455.5
274,Ostrobothnia,2015,5.5,326.2,361.5,343.8,19931,53083,17125,18705,49324,20737,38636,102407,37862,176894,5906.8
275,Ostrobothnia,2016,5.5,329.2,367.1,348.1,19909,52726,17498,18730,48801,21056,38639,101527,38554,176729,5924.8
276,Ostrobothnia,2017,5.4,335.1,375.9,355.5,19849,52288,17931,18709,48233,21287,38558,100521,39218,176272,5856.6
277,Ostrobothnia,2018,5.4,342.4,386.2,364.2,19718,52077,18263,18619,47911,21571,38337,99988,39834,176193,6013.6
278,Ostrobothnia,2019,5.3,345.3,391.4,368.2,19607,51735,18678,18462,47487,21871,38069,99222,40549,175923,6195.4
279,Ostrobothnia,2020,5.4,348.2,396.6,372.3,19437,51505,18938,18407,47342,22197,37844,98847,41135,175816,6346.1
280,Pirkanmaa,1993,6.8,252.6,225.9,238.5,51240,138158,23541,48811,136693,42596,100051,274851,66137,435789,2436.1
281,Pirkanmaa,1994,6.6,257.5,232.3,244.2,51343,138925,24098,48932,137053,43212,100275,275978,67310,438114,2440.5
282,Pirkanmaa,1995,6.9,263.2,239.0,250.5,51394,139678,24752,49018,137591,43725,100412,277269,68477,440734,2567.4
283,Pirkanmaa,1996,7.0,268.3,245.6,256.4,51256,140527,25320,48902,138186,44056,100158,278713,69376,443065,2700.5
284,Pirkanmaa,1997,7.1,273.5,252.2,262.4,51327,141498,25776,49025,138842,44279,100352,280340,70055,445536,2549.5
285,Pirkanmaa,1998,7.2,279.0,258.5,268.3,51373,142480,26196,49052,139692,44464,100425,282172,70660,448045,2623.1
286,Pirkanmaa,1999,7.2,283.9,265.4,274.2,51293,143504,26600,49192,140649,44648,100485,284153,71248,450548,2719.1
287,Pirkanmaa,2000,7.2,288.7,272.0,280.0,51299,144816,27092,49097,141792,44814,100396,286608,71906,453319,2839.4
288,Pirkanmaa,2001,7.5,293.4,278.9,285.9,51173,146329,27735,49038,143250,45070,100211,289579,72805,456934,3047.1
289,Pirkanmaa,2002,7.7,299.1,285.1,291.8,50966,147925,28254,48779,144306,45367,99745,292231,73621,460103,3221.5
290,Pirkanmaa,2003,7.8,304.2,292.7,298.3,50879,148850,29089,48744,145186,45935,99623,294036,75024,463330,3365.2
291,Pirkanmaa,2004,8.2,308.8,299.7,304.1,51028,149949,29827,48942,146082,46694,99970,296031,76521,467424,3644.9
292,Pirkanmaa,2005,8.2,313.6,306.5,309.9,51352,151156,30434,49252,147340,47003,100604,298496,77437,471409,3819.8
293,Pirkanmaa,2006,8.4,319.0,314.3,316.6,51665,152150,31680,49713,148054,47983,101378,300204,79663,475645,4018.3
294,Pirkanmaa,2007,8.6,323.1,321.1,322.1,51850,153938,32184,49892,149790,48377,101742,303728,80561,480634,4169.3
295,Pirkanmaa,2008,8.5,328.6,330.1,329.4,52130,155148,33065,50155,150868,48997,102285,306016,82062,484638,4422.9
296,Pirkanmaa,2009,8.2,333.6,336.1,334.9,52351,155907,33989,50266,151683,49771,102617,307590,83760,488295,4636.9
297,Pirkanmaa,2010,8.0,339.4,343.1,341.3,52540,156222,35445,50501,151925,51005,103041,308147,86450,491746,4670.4
298,Pirkanmaa,2011,8.0,343.1,349.2,346.3,52576,156092,37290,50671,151617,52770,103247,307709,90060,495242,4862.5
299,Pirkanmaa,2012,7.6,347.6,356.2,352.0,52817,155842,39267,50921,151514,54483,103738,307356,93750,499006,5155.5
300,Pirkanmaa,2013,7.4,353.4,363.6,358.6,52954,155798,41178,50910,151175,56199,103864,306973,97377,502575,5387.5
301,Pirkanmaa,2014,7.2,358.1,370.0,364.2,53027,155515,42862,51010,151079,57732,104037,306594,100594,505755,5472.3
302,Pirkanmaa,2015,7.0,360.9,375.3,368.3,53057,155377,44385,51147,151017,58972,104204,306394,103357,508448,5472.1
303,Pirkanmaa,2016,6.9,364.7,381.0,373.0,53132,155625,45601,51232,150942,60383,104364,306567,105984,511642,5516.8
304,Pirkanmaa,2017,6.9,369.3,387.3,378.5,53094,155989,46876,51204,151023,61597,104298,307012,108473,514333,5500.5
305,Pirkanmaa,2018,7.0,376.4,396.0,386.4,52885,156532,48043,50904,151504,62801,103789,308036,110844,517333,5624.3
306,Pirkanmaa,2019,6.8,380.3,401.7,391.2,52566,157063,49142,50663,151757,64099,103229,308820,113241,519872,5770.9
307,Pirkanmaa,2020,6.8,384.6,408.0,396.6,52248,157678,50295,50368,152383,65185,102616,310061,115480,522852,5899.4
308,Päijät-Häme,1993,7.3,226.3,209.4,217.4,24446,65784,10463,23729,65191,19284,48175,130975,29747,206233,2522.6
309,Päijät-Häme,1994,7.1,229.7,214.2,221.5,24354,65673,10748,23634,64921,19542,47988,130594,30290,206171,2496.7
310,Päijät-Häme,1995,7.2,233.5,219.5,226.1,24258,65454,10976,23479,64612,19846,47737,130066,30822,205973,2618.4
311,Päijät-Häme,1996,7.3,237.5,223.9,230.3,24048,65092,11196,23317,64266,20034,47365,129358,31230,205394,2785.1
312,Päijät-Häme,1997,7.5,240.5,229.7,234.8,23870,65033,11417,23163,64303,20093,47033,129336,31510,205338,2479.3
313,Päijät-Häme,1998,7.4,243.9,235.2,239.3,23602,65050,11509,23010,64322,20179,46612,129372,31688,205030,2544.5
314,Päijät-Häme,1999,7.4,247.1,240.4,243.6,23328,65008,11719,22774,64195,20402,46102,129203,32121,204858,2635.3
315,Päijät-Häme,2000,7.4,249.9,244.9,247.2,23182,64995,12089,22629,64023,20675,45811,129018,32764,204912,2752.8
316,Päijät-Häme,2001,7.8,253.0,249.8,251.3,22891,65062,12394,22456,64043,20908,45347,129105,33302,205071,2914.4
317,Päijät-Häme,2002,8.1,257.2,254.5,255.8,22646,65069,12796,22239,64148,21224,44885,129217,34020,205464,3060.7
318,Päijät-Häme,2003,8.3,260.6,260.3,260.5,22385,65006,13219,22002,64105,21592,44387,129111,34811,205755,3265.1
319,Päijät-Häme,2004,8.7,264.3,266.3,265.3,22257,64828,13726,21792,63912,21998,44049,128740,35724,206021,3473.1
320,Päijät-Häme,2005,8.8,268.1,271.6,269.9,22172,64582,14080,21673,63788,22290,43845,128370,36370,206240,3621.5
321,Päijät-Häme,2006,9.0,272.5,277.8,275.3,22139,64130,14790,21597,63212,23057,43736,127342,37847,206481,3698.0
322,Päijät-Häme,2007,9.3,276.9,283.9,280.6,22080,64409,15038,21516,63617,23163,43596,128026,38201,207269,3916.5
323,Päijät-Häme,2008,9.2,280.8,290.3,285.8,21991,64510,15545,21418,63697,23456,43409,128207,39001,207940,4241.1
324,Päijät-Häme,2009,9.0,284.2,295.8,290.3,21740,64439,16028,21292,63606,23832,43032,128045,39860,208314,4422.0
325,Päijät-Häme,2010,8.8,288.3,301.4,295.1,21603,64100,16806,21131,63379,24491,42734,127479,41297,208777,4534.6
326,Päijät-Häme,2011,8.9,291.8,307.4,299.9,21367,63571,17802,20789,62961,25362,42156,126532,43164,209238,4781.7
327,Päijät-Häme,2012,8.4,295.4,312.8,304.5,21186,62927,18780,20600,62466,26208,41786,125393,44988,209503,5074.3
328,Päijät-Häme,2013,8.2,299.9,319.0,309.9,20975,62117,19778,20308,61647,27107,41283,123764,46885,209405,5352.8
329,Päijät-Häme,2014,7.9,303.9,324.3,314.5,20783,61199,20638,20055,60819,27884,40838,122018,48522,208959,5186.3
330,Päijät-Häme,2015,7.8,305.2,327.9,317.0,20557,60421,21462,19826,59897,28692,40383,120318,50154,208525,5467.8
331,Päijät-Häme,2016,7.6,307.7,332.6,320.6,20499,60024,22140,19619,59190,29347,40118,119214,51487,208574,5546.2
332,Päijät-Häme,2017,7.7,311.5,337.7,325.1,20423,59367,22809,19410,58324,30068,39833,117691,52877,208048,5460.6
333,Päijät-Häme,2018,7.7,316.5,345.0,331.3,20136,58889,23328,19120,57552,30648,39256,116441,53976,207394,5630.5
334,Päijät-Häme,2019,7.5,319.1,349.6,334.9,19771,58140,23888,18788,56677,31242,38559,114817,55130,206315,5920.0
335,Päijät-Häme,2020,7.6,322.1,354.3,338.8,19533,57673,24415,18575,55999,31755,38108,113672,56170,205771,6036.0
336,Satakunta,1993,6.3,222.1,205.2,213.3,28779,76499,13515,27725,73885,23341,56504,150384,36856,240519,2587.0
337,Satakunta,1994,6.2,226.3,210.8,218.2,28552,76280,13823,27488,73593,23568,56040,149873,37391,240028,2604.9
338,Satakunta,1995,6.4,230.2,215.8,222.7,28306,75900,14107,27215,72998,23901,55521,148898,38008,239255,2676.2
339,Satakunta,1996,6.4,233.8,221.3,227.3,28021,75295,14455,26876,72608,24028,54897,147903,38483,238057,2766.8
340,Satakunta,1997,6.5,237.2,226.6,231.7,27562,74802,14740,26440,72140,24138,54002,146942,38878,236818,2721.5
341,Satakunta,1998,6.6,240.8,231.3,235.9,27293,74482,14953,26061,71722,24191,53354,146204,39144,235662,2820.2
342,Satakunta,1999,6.8,243.8,236.2,239.8,26933,73929,15214,25720,71175,24343,52653,145104,39557,234233,2885.6
343,Satakunta,2000,6.8,246.7,241.1,243.8,26480,73385,15589,25175,70597,24512,51655,143982,40101,232569,2962.5
344,Satakunta,2001,7.1,249.5,246.2,247.8,26029,72980,15972,24639,70059,24781,50668,143039,40753,231307,3162.8
345,Satakunta,2002,7.4,252.9,251.0,252.0,25524,72692,16384,24200,69788,24980,49724,142480,41364,230480,3338.7
346,Satakunta,2003,7.5,256.4,257.0,256.7,25170,72297,16820,23752,69423,25312,48922,141720,42132,229910,3521.4
347,Satakunta,2004,8.2,260.0,263.2,261.6,24860,71752,17327,23558,68892,25788,48418,140644,43115,229389,3692.0
348,Satakunta,2005,8.2,263.4,268.6,266.1,24628,71401,17607,23250,68443,26019,47878,139844,43626,228675,3892.2
349,Satakunta,2006,8.4,266.7,274.7,270.8,24413,70661,18286,23139,67751,26558,47552,138412,44844,228051,4125.3
350,Satakunta,2007,8.8,270.0,280.6,275.5,24119,70343,18449,22893,67551,26573,47012,137894,45022,227131,4324.1
351,Satakunta,2008,8.7,273.6,286.2,280.1,23782,70023,18790,22598,67175,26893,46380,137198,45683,226358,4678.8
352,Satakunta,2009,8.6,277.4,291.8,284.8,23494,69664,19268,22367,66874,27175,45861,136538,46443,226116,4908.1
353,Satakunta,2010,8.3,280.8,298.0,289.6,23350,69182,19925,22094,66331,27709,45444,135513,47634,225762,4914.0
354,Satakunta,2011,8.3,284.1,303.8,294.2,23091,68268,20774,21883,65468,28395,44974,133736,49169,225302,5179.1
355,Satakunta,2012,7.8,287.5,309.6,298.9,22978,67449,21699,21745,64639,29172,44723,132088,50871,224934,5375.6
356,Satakunta,2013,7.6,292.2,316.1,304.5,22701,66688,22569,21564,63848,29906,44265,130536,52475,224556,5466.5
357,Satakunta,2014,7.5,295.9,321.5,309.0,22480,65953,23412,21283,63045,30464,43763,128998,53876,223985,5656.8
358,Satakunta,2015,7.3,297.3,325.6,311.8,22114,65033,24082,21012,62007,31130,43126,127040,55212,222957,5803.7
359,Satakunta,2016,7.3,299.1,330.6,315.2,21881,64281,24703,20766,61015,31455,42647,125296,56158,221740,5701.8
360,Satakunta,2017,7.3,302.0,336.2,319.4,21588,63467,25293,20538,60029,31901,42126,123496,57194,220398,5665.8
361,Satakunta,2018,7.4,308.0,343.2,325.9,21229,62521,25777,20140,58958,32302,41369,121479,58079,218624,5930.0
362,Satakunta,2019,7.1,310.8,347.7,329.6,20772,61522,26217,19798,58013,32661,40570,119535,58878,216752,6138.2
363,Satakunta,2020,7.3,312.9,352.8,333.2,20491,60843,26638,19543,57208,32950,40034,118051,59588,215416,6211.8
364,South Karelia,1993,7.3,219.1,202.2,210.4,16008,45212,8086,15255,42696,14078,31263,87908,22164,139569,2586.3
365,South Karelia,1994,6.9,222.7,207.2,214.7,15894,44999,8344,15131,42423,14267,31025,87422,22611,139297,2625.5
366,South Karelia,1995,6.2,227.0,213.2,219.9,15797,44748,8544,14893,42006,14431,30690,86754,22975,138678,2627.8
367,South Karelia,1996,6.5,231.1,217.9,224.3,15568,44565,8724,14747,41709,14554,30315,86274,23278,138163,2725.7
368,South Karelia,1997,7.1,235.4,223.8,229.5,15391,44460,8881,14679,41578,14641,30070,86038,23522,137944,2471.8
369,South Karelia,1998,7.2,238.9,228.9,233.8,15151,44290,8942,14441,41319,14779,29592,85609,23721,137238,2586.4
370,South Karelia,1999,7.2,242.9,234.1,238.4,14899,44069,9077,14244,41014,14859,29143,85083,23936,136525,2650.5
371,South Karelia,2000,7.1,246.7,239.4,243.0,14785,43899,9273,14068,40912,15019,28853,84811,24292,136299,2789.3
372,South Karelia,2001,7.6,251.1,245.6,248.3,14651,43968,9497,13904,40790,15119,28555,84758,24616,136161,2994.3
373,South Karelia,2002,7.9,255.7,251.0,253.3,14336,43874,9692,13613,40655,15285,27949,84529,24977,135840,3211.2
374,South Karelia,2003,8.0,260.0,257.8,258.9,14146,43664,9961,13412,40464,15431,27558,84128,25392,135458,3371.2
375,South Karelia,2004,8.6,264.7,264.2,264.4,13915,43319,10244,13220,40163,15633,27135,83482,25877,134962,3512.3
376,South Karelia,2005,8.8,269.3,270.3,269.8,13787,43168,10407,13142,40104,15701,26929,83272,26108,134790,3628.1
377,South Karelia,2006,9.0,273.3,276.8,275.1,13680,42743,10907,12991,39633,16111,26671,82376,27018,134441,3773.6
378,South Karelia,2007,9.5,277.3,282.8,280.1,13446,42700,10931,12859,39446,16119,26305,82146,27050,133899,3932.2
379,South Karelia,2008,9.3,281.0,290.1,285.6,13243,42556,11190,12712,39309,16248,25955,81865,27438,133647,4288.9
380,South Karelia,2009,9.2,285.2,296.6,291.0,13022,42383,11396,12526,39072,16384,25548,81455,27780,133210,4496.3
381,South Karelia,2010,9.1,289.6,302.9,296.4,12890,42084,11779,12407,38763,16676,25297,80847,28455,132899,4589.2
382,South Karelia,2011,9.4,293.1,308.3,300.8,12631,41517,12273,12245,38327,17071,24876,79844,29344,132527,4796.9
383,South Karelia,2012,8.8,297.1,313.9,305.6,12484,41053,12796,12157,37929,17537,24641,78982,30333,132355,5053.5
384,South Karelia,2013,9.0,302.1,320.4,311.4,12302,40655,13286,11987,37521,17972,24289,78176,31258,132252,5254.9
385,South Karelia,2014,8.5,306.9,326.1,316.6,12141,40127,13725,11887,37061,18303,24028,77188,32028,131764,5532.3
386,South Karelia,2015,8.2,309.3,330.7,320.1,12015,39609,14102,11664,36559,18638,23679,76168,32740,131155,5813.9
387,South Karelia,2016,8.1,313.1,335.7,324.6,11834,39143,14444,11464,36100,18828,23298,75243,33272,130506,6001.7
388,South Karelia,2017,8.2,317.7,341.7,329.9,11705,38648,14751,11307,35599,19165,23012,74247,33916,129865,5921.8
389,South Karelia,2018,8.1,325.7,351.2,338.6,11455,38100,15049,11043,34964,19418,22498,73064,34467,128756,5862.0
390,South Karelia,2019,8.0,328.7,356.6,342.8,11223,37699,15345,10788,34367,19638,22011,72066,34983,127757,5976.0
391,South Karelia,2020,8.3,333.3,362.7,348.1,10949,37305,15590,10520,33913,19899,21469,71218,35489,126921,6477.0
392,South Ostrobothnia,1993,4.4,202.2,202.2,202.2,27740,63326,12704,26372,59856,20812,54112,123182,33516,207862,2612.6
393,South Ostrobothnia,1994,4.4,206.8,208.0,207.4,27584,63292,12928,26187,59489,21042,53771,122781,33970,207514,2653.6
394,South Ostrobothnia,1995,4.7,210.6,213.2,211.9,27119,62951,13101,25820,58916,21207,52939,121867,34308,206136,2759.9
395,South Ostrobothnia,1996,4.8,214.3,217.9,216.1,26687,62615,13296,25558,58565,21325,52245,121180,34621,205108,2905.8
396,South Ostrobothnia,1997,4.9,218.2,223.5,220.9,26336,62228,13524,25113,58160,21476,51449,120388,35000,203907,2634.8
397,South Ostrobothnia,1998,5.0,222.1,229.6,226.0,26042,62025,13594,24701,58014,21524,50743,120039,35118,202935,2731.7
398,South Ostrobothnia,1999,5.1,225.9,235.5,230.8,25670,61833,13761,24328,57778,21572,49998,119611,35333,202002,2846.1
399,South Ostrobothnia,2000,5.2,229.6,240.4,235.2,25327,61572,13959,23868,57363,21638,49195,118935,35597,200766,2935.6
400,South Ostrobothnia,2001,5.4,232.5,245.8,239.3,24981,61221,14128,23499,57172,21727,48480,118393,35855,199639,3168.7
401,South Ostrobothnia,2002,5.6,236.6,250.2,243.5,24564,61319,14315,23033,57132,21804,47597,118451,36119,199190,3287.9
402,South Ostrobothnia,2003,5.8,241.0,256.6,248.9,24167,61369,14532,22712,57135,21915,46879,118504,36447,199019,3462.8
403,South Ostrobothnia,2004,6.2,245.1,262.8,254.2,23906,61253,14930,22486,57082,22138,46392,118335,37068,199150,3675.1
404,South Ostrobothnia,2005,6.4,249.9,269.2,259.7,23721,61216,15008,22280,57114,22096,46001,118330,37104,198856,3839.5
405,South Ostrobothnia,2006,6.6,254.5,275.8,265.4,23519,60945,15397,22184,56826,22458,45703,117771,37855,198626,3960.3
406,South Ostrobothnia,2007,6.8,258.6,282.0,270.5,23443,61161,15442,21962,57121,22354,45405,118282,37796,198831,4185.8
407,South Ostrobothnia,2008,6.8,263.2,289.0,276.4,23287,61109,15642,21806,56987,22416,45093,118096,38058,198502,4513.0
408,South Ostrobothnia,2009,6.7,267.7,295.1,281.6,23061,61059,15896,21707,56955,22511,44768,118014,38407,198477,4749.6
409,South Ostrobothnia,2010,6.6,271.9,301.2,286.8,22892,60711,16448,21627,56752,22758,44519,117463,39206,198469,4861.8
410,South Ostrobothnia,2011,6.7,275.9,307.6,292.0,22683,60274,17130,21540,56415,23263,44223,116689,40393,198671,5128.0
411,South Ostrobothnia,2012,6.3,279.5,314.0,297.0,22674,59751,17867,21493,55987,23789,44167,115738,41656,198944,5409.8
412,South Ostrobothnia,2013,6.2,283.8,320.4,302.4,22549,59084,18639,21271,55351,24387,43820,114435,43026,198831,5626.9
413,South Ostrobothnia,2014,6.0,287.9,326.3,307.4,22376,58347,19224,21060,54695,24935,43436,113042,44159,198241,5735.9
414,South Ostrobothnia,2015,5.9,290.3,330.9,310.9,22198,57426,19867,20894,53928,25417,43092,111354,45284,197371,5855.9
415,South Ostrobothnia,2016,5.8,294.5,337.0,316.0,21966,56645,20470,20803,53304,25699,42769,109949,46169,196572,5872.1
416,South Ostrobothnia,2017,5.8,298.8,343.3,321.4,21722,55777,21044,20636,52534,26164,42358,108311,47208,195583,5913.0
417,South Ostrobothnia,2018,5.9,303.2,350.1,326.9,21455,55078,21613,20242,51801,26456,41697,106879,48069,194316,6128.4
418,South Ostrobothnia,2019,5.8,306.6,355.6,331.4,21139,54336,22192,19998,50978,26903,41137,105314,49095,193207,6541.5
419,South Ostrobothnia,2020,5.9,310.3,361.1,335.9,20714,53688,22742,19665,50297,27261,40379,103985,50003,192150,6585.7
420,South Savo,1993,7.4,208.3,211.4,209.9,19092,51762,9826,18422,49441,16707,37514,101203,26533,163130,2701.6
421,South Savo,1994,7.3,211.4,216.3,214.0,18912,51507,10141,18230,49131,16989,37142,100638,27130,162691,2700.7
422,South Savo,1995,7.5,215.6,221.7,218.7,18642,51122,10414,17914,48753,17267,36556,99875,27681,162033,2810.3
423,South Savo,1996,7.4,219.5,226.7,223.2,18385,50655,10619,17732,48273,17462,36117,98928,28081,161128,2886.9
424,South Savo,1997,7.6,223.1,231.5,227.4,18126,50078,10902,17454,47858,17642,35580,97936,28544,160077,2613.7
425,South Savo,1998,7.8,226.6,236.8,231.9,17758,49487,11076,17147,47413,17746,34905,96900,28822,158725,2722.5
426,South Savo,1999,7.9,229.2,241.0,235.3,17557,48934,11231,16822,46868,17911,34379,95802,29142,157334,2822.2
427,South Savo,2000,7.9,232.1,246.1,239.3,17230,48397,11527,16531,46385,18095,33761,94782,29622,156117,2894.7
428,South Savo,2001,8.3,235.5,251.2,243.6,16859,48087,11759,16199,45975,18212,33058,94062,29971,154978,3163.6
429,South Savo,2002,8.7,239.1,256.1,247.9,16395,47729,12047,15751,45639,18391,32146,93368,30438,153864,3358.8
430,South Savo,2003,8.8,243.0,261.8,252.8,16072,47333,12399,15337,45196,18629,31409,92529,31028,152965,3463.0
431,South Savo,2004,9.3,246.9,267.2,257.4,15681,47013,12688,15077,44724,18902,30758,91737,31590,152171,3613.7
432,South Savo,2005,9.4,250.8,272.7,262.1,15371,46696,12832,14804,44520,18952,30175,91216,31784,151395,3789.4
433,South Savo,2006,9.7,254.6,278.6,267.0,15177,46140,13281,14584,43926,19275,29761,90066,32556,150471,3981.3
434,South Savo,2007,10.1,258.2,283.8,271.4,14814,45807,13337,14224,43518,19243,29038,89325,32580,149032,4119.9
435,South Savo,2008,9.9,262.6,290.1,276.8,14498,45283,13628,13912,43165,19326,28410,88448,32954,147892,4524.8
436,South Savo,2009,9.8,266.1,296.0,281.5,14150,44830,13929,13560,42923,19411,27710,87753,33340,146979,4618.1
437,South Savo,2010,9.7,270.8,301.4,286.6,13882,44317,14360,13238,42407,19703,27120,86724,34063,146166,4858.3
438,South Savo,2011,9.9,274.9,307.4,291.6,13654,43699,14828,12992,41683,20170,26646,85382,34998,145353,5215.3
439,South Savo,2012,9.3,279.0,313.7,296.8,13364,42977,15402,12722,40924,20729,26086,83901,36131,144393,5471.6
440,South Savo,2013,9.2,283.8,320.1,302.5,13104,42210,16000,12464,40372,21139,25568,82582,37139,143638,5732.5
441,South Savo,2014,8.9,288.1,326.4,307.8,12881,41485,16498,12201,39758,21529,25082,81243,38027,142744,5859.7
442,South Savo,2015,8.7,290.7,330.4,311.1,12670,40749,16920,11953,38952,21906,24623,79701,38826,141621,5961.7
443,South Savo,2016,8.7,293.9,335.4,315.3,12472,40015,17316,11746,38209,22188,24218,78224,39504,140422,6039.0
444,South Savo,2017,8.6,298.5,341.8,320.8,12148,39105,17767,11488,37289,22505,23636,76394,40272,138822,6159.6
445,South Savo,2018,8.7,302.2,348.2,325.7,11774,38043,18183,11176,36049,22665,22950,74092,40848,136474,6414.1
446,South Savo,2019,8.5,305.2,352.7,329.5,11411,37005,18541,10881,34952,22906,22292,71957,41447,134314,6656.2
447,South Savo,2020,9.0,307.9,357.9,333.4,11127,36196,18929,10565,34041,23166,21692,70237,42095,132702,6876.4
448,Southwest Finland,1993,6.8,249.7,224.9,236.6,50345,135203,24281,48386,134613,42926,98731,269816,67207,430409,2503.3
449,Southwest Finland,1994,6.7,254.5,231.2,242.2,50336,135778,24820,48332,135194,43493,98668,270972,68313,432603,2532.2
450,Southwest Finland,1995,6.7,260.2,238.0,248.5,50317,136578,25403,48373,136068,43901,98690,272646,69304,435119,2594.2
451,Southwest Finland,1996,6.8,264.5,244.3,253.9,50233,137339,25958,48191,136934,44198,98424,274273,70156,437491,2724.5
452,Southwest Finland,1997,6.9,269.1,251.0,259.6,50293,138141,26333,48024,137842,44522,98317,275983,70855,439973,2670.9
453,Southwest Finland,1998,6.9,273.1,256.9,264.6,50448,139307,26610,48082,139094,44760,98530,278401,71370,443050,2835.5
454,Southwest Finland,1999,7.1,277.3,262.6,269.6,50432,140275,26904,48189,140059,45034,98621,280334,71938,445542,2904.9
455,Southwest Finland,2000,7.1,280.8,268.6,274.4,50283,140887,27369,48024,140853,45167,98307,281740,72536,447103,2996.6
456,Southwest Finland,2001,7.4,284.5,274.4,279.2,50124,141710,27869,47756,141906,45494,97880,283616,73363,449293,3248.8
457,Southwest Finland,2002,7.6,288.8,280.1,284.2,49826,142228,28485,47330,142750,45689,97156,284978,74174,450969,3399.0
458,Southwest Finland,2003,7.6,292.9,286.8,289.7,49537,142401,29228,47054,143259,46148,96591,285660,75376,452444,3589.0
459,Southwest Finland,2004,8.2,297.0,293.3,295.1,49459,142442,30067,46793,143352,46676,96252,285794,76743,453745,3813.5
460,Southwest Finland,2005,8.2,300.8,299.6,300.2,49367,143042,30568,46706,143971,46898,96073,287013,77466,455584,4003.8
461,Southwest Finland,2006,8.4,305.0,306.7,305.9,49376,143218,31709,46846,144081,47949,96222,287299,79658,457789,4149.2
462,Southwest Finland,2007,8.7,308.8,313.5,311.2,49023,143900,32150,46801,144683,47951,95824,288583,80101,459235,4333.2
463,Southwest Finland,2008,8.6,313.8,322.4,318.2,49003,144305,33061,46763,145041,48426,95766,289346,81487,461177,4705.2
464,Southwest Finland,2009,8.4,317.3,328.3,323.0,48818,144544,34111,46623,145110,49207,95441,289654,83318,462914,4816.7
465,Southwest Finland,2010,8.1,321.0,334.1,327.8,48790,144433,35646,46579,144798,50517,95369,289231,86163,465183,4997.6
466,Southwest Finland,2011,8.2,324.3,340.1,332.5,48601,143767,37568,46354,144155,52260,94955,287922,89828,467217,5169.4
467,Southwest Finland,2012,7.7,327.5,346.2,337.2,48446,142947,39522,46131,143529,53939,94577,286476,93461,468936,5408.4
468,Southwest Finland,2013,7.6,332.3,353.0,343.1,48283,142464,41318,45841,142838,55552,94124,285302,96870,470880,5541.7
469,Southwest Finland,2014,7.4,336.2,358.6,347.8,48016,142139,42875,45681,142301,57010,93697,284440,99885,472726,5472.2
470,Southwest Finland,2015,7.2,338.2,363.5,351.3,47825,141756,44368,45458,141692,58437,93283,283448,102805,474323,5431.6
471,Southwest Finland,2016,7.1,341.2,369.6,355.9,47412,141743,45537,45155,141175,59566,92567,282918,105103,475543,5506.9
472,Southwest Finland,2017,7.1,345.9,376.6,361.8,47111,142251,46747,45066,140853,60868,92177,283104,107615,477677,5517.9
473,Southwest Finland,2018,7.1,352.9,386.0,370.0,46670,142290,47759,44571,140473,61890,91241,282763,109649,478582,5650.4
474,Southwest Finland,2019,7.0,356.4,391.6,374.6,46271,142062,48743,44055,140008,63072,90326,282070,111815,479341,5861.0
475,Southwest Finland,2020,7.1,359.4,397.5,379.0,46021,142396,49924,43750,139933,64195,89771,282329,114119,481403,5933.1
476,Uusimaa,1993,7.7,307.8,272.4,288.9,153908,413542,49631,146761,433821,95172,300669,847363,144803,1277609,2846.8
477,Uusimaa,1994,7.4,312.1,278.8,294.3,155910,418288,51204,149005,438275,96395,304915,856563,147599,1293573,2880.9
478,Uusimaa,1995,7.5,317.4,285.7,300.5,157614,423582,52824,150781,443613,97547,308395,867195,150371,1310680,2916.1
479,Uusimaa,1996,7.6,322.7,292.7,306.7,159311,428886,54316,152410,448896,98462,311721,877782,152778,1327243,3069.3
480,Uusimaa,1997,7.8,327.7,300.3,313.1,160739,435071,55748,154366,454968,99345,315105,890039,155093,1344989,2849.6
481,Uusimaa,1998,7.8,332.3,307.8,319.3,162003,441889,56991,155548,461257,99965,317551,903146,156956,1362634,2895.0
482,Uusimaa,1999,7.9,336.8,315.2,325.4,163093,448159,58337,157119,467442,100902,320212,915601,159239,1379712,2975.0
483,Uusimaa,2000,7.8,340.6,322.6,331.1,164049,453767,59819,157969,473041,101928,322018,926808,161747,1394199,3159.2
484,Uusimaa,2001,8.1,344.0,329.8,336.5,164262,459250,61406,158400,478598,102921,322662,937848,164327,1408525,3423.6
485,Uusimaa,2002,8.2,347.3,335.0,340.8,164810,462867,63111,158718,482298,104281,323528,945165,167392,1419938,3632.9
486,Uusimaa,2003,8.2,350.5,341.8,345.9,165179,465451,65339,159245,484566,105880,324424,950017,171219,1429869,3685.4
487,Uusimaa,2004,8.6,353.8,348.4,351.0,165745,467510,67670,159876,485770,108339,325621,953280,176009,1439400,3742.6
488,Uusimaa,2005,8.5,356.5,354.3,355.4,166352,471559,69692,160862,489378,110068,327214,960937,179760,1452083,3949.3
489,Uusimaa,2006,8.6,360.0,361.2,360.7,167537,474841,73496,161898,492601,114050,329435,967442,187546,1467453,4068.4
490,Uusimaa,2007,8.8,362.8,367.5,365.2,168231,481347,75270,162238,498285,115664,330469,979632,190934,1483719,4289.0
491,Uusimaa,2008,8.6,367.0,376.6,372.0,169199,487205,78449,163060,503105,118712,332259,990310,197161,1501511,4590.1
492,Uusimaa,2009,8.2,370.1,382.1,376.4,169725,491343,81872,163785,507105,122259,333510,998448,204131,1517712,4755.9
493,Uusimaa,2010,8.1,374.4,388.0,381.5,170486,493786,86698,164068,508742,127479,334554,1002528,214177,1532309,4836.5
494,Uusimaa,2011,8.1,377.2,393.6,385.7,170824,496478,92307,164193,510329,133666,335017,1006807,225973,1549058,5010.0
495,Uusimaa,2012,7.7,379.9,399.0,389.9,171397,500065,97658,164547,512298,139658,335944,1012363,237316,1566835,5233.3
496,Uusimaa,2013,7.4,384.7,405.8,395.7,172190,503520,102848,165186,514502,145578,337376,1018022,248426,1585473,5372.4
497,Uusimaa,2014,7.1,387.2,410.7,399.5,173099,506891,107495,166167,516635,150785,339266,1023526,258280,1603389,5350.9
498,Uusimaa,2015,6.8,388.1,414.4,401.8,174341,510365,111500,167229,518801,155496,341570,1029166,266996,1620261,5581.6
499,Uusimaa,2016,6.7,391.0,419.8,406.0,176139,515194,114945,167942,521485,159579,344081,1036679,274524,1638293,5445.6
500,Uusimaa,2017,6.7,395.9,426.6,411.9,177526,519853,118637,169180,523865,164148,346706,1043718,282785,1655624,5289.9
501,Uusimaa,2018,6.7,407.0,438.4,423.3,177892,524299,121930,169823,526400,168216,347715,1050699,290146,1671024,5405.4
502,Uusimaa,2019,6.5,409.5,443.5,427.1,178327,530600,125213,170390,530100,172629,348717,1060700,297842,1689725,5689.7
503,Uusimaa,2020,6.4,412.2,449.0,431.2,178719,534107,128223,170864,532135,176135,349583,1066242,304358,1702678,5882.3
504,Åland,1993,5.3,241.1,199.1,219.4,3016,7876,1632,2788,7625,2467,5804,15501,4099,25102,2247.5
505,Åland,1994,5.3,244.9,204.3,224.0,2990,7871,1655,2825,7629,2489,5815,15500,4144,25158,1951.8
506,Åland,1995,4.7,248.2,211.0,229.0,3008,7851,1653,2837,7657,2453,5845,15508,4106,25202,2027.7
507,Åland,1996,4.7,250.4,217.2,233.3,3052,7837,1656,2848,7697,2449,5900,15534,4105,25257,2171.4
508,Åland,1997,4.8,253.4,220.5,236.4,3051,7838,1694,2889,7724,2464,5940,15562,4158,25392,786.9
509,Åland,1998,4.8,255.7,225.7,240.2,3075,7973,1710,2910,7823,2467,5985,15796,4177,25625,0.0
510,Åland,1999,5.0,259.2,231.2,244.8,3062,8017,1720,2906,7829,2457,5968,15846,4177,25706,2535.0
511,Åland,2000,5.0,260.4,234.9,247.3,3069,8037,1757,2902,7853,2467,5971,15890,4224,25776,2769.5
512,Åland,2001,5.1,265.3,242.0,253.3,3054,8100,1783,2921,7942,2497,5975,16042,4280,26008,2931.7
513,Åland,2002,5.2,266.9,245.2,255.7,3085,8164,1824,2917,8037,2512,6002,16201,4336,26257,3105.3
514,Åland,2003,5.3,267.4,246.0,256.3,3076,8181,1857,2929,8097,2504,6005,16278,4361,26347,3242.2
515,Åland,2004,5.5,267.0,250.5,258.5,3114,8270,1884,2931,8115,2527,6045,16385,4411,26530,3365.4
516,Åland,2005,5.5,267.8,255.7,261.6,3106,8356,1946,2920,8201,2548,6026,16557,4494,26766,3527.4
517,Åland,2006,5.7,270.9,261.6,266.1,3131,8377,2017,2923,8289,2546,6054,16666,4563,26923,3647.2
518,Åland,2007,5.9,272.6,265.6,269.0,3120,8456,2079,2902,8348,2598,6022,16804,4677,27153,3742.2
519,Åland,2008,5.7,273.7,270.3,272.0,3129,8538,2169,2920,8453,2610,6049,16991,4779,27456,3994.7
520,Åland,2009,5.8,274.0,275.1,274.6,3123,8610,2252,2903,8514,2681,6026,17124,4933,27734,4055.9
521,Åland,2010,5.7,273.4,278.9,276.2,3107,8675,2358,2889,8549,2787,5996,17224,5145,28007,4172.4
522,Åland,2011,5.9,273.8,283.4,278.6,3099,8742,2472,2925,8586,2885,6024,17328,5357,28354,4274.4
523,Åland,2012,5.6,276.4,288.1,282.3,3090,8695,2579,2931,8584,2947,6021,17279,5526,28501,4492.4
524,Åland,2013,5.7,282.0,295.6,288.9,3127,8685,2680,2920,8607,3025,6047,17292,5705,28666,4418.4
525,Åland,2014,5.5,283.3,298.5,291.0,3134,8713,2776,2910,8596,3123,6044,17309,5899,28916,4449.3
526,Åland,2015,5.4,280.9,298.2,289.6,3104,8709,2828,2900,8568,3195,6004,17277,6023,28983,5000.4
527,Åland,2016,5.4,281.6,301.9,291.8,3147,8716,2892,2939,8594,3277,6086,17310,6169,29214,4740.8
528,Åland,2017,5.4,318.8,344.4,331.8,3156,8758,2984,2947,8562,3417,6103,17320,6401,29489,4759.4
529,Åland,2018,5.2,322.8,351.4,337.3,3212,8727,3105,2995,8540,3515,6207,17267,6620,29789,4957.4
530,Åland,2019,5.0,325.0,356.8,341.2,3201,8662,3181,3022,8526,3605,6223,17188,6786,29884,5133.2
531,Åland,2020,6.2,324.3,358.4,341.6,3201,8700,3240,3058,8543,3691,6259,17243,6931,30129,4976.1
